WORD_ID,IN_SPAM,IN_HAM,OVERALL,PROB_SPAM,PROB_HAM,PROB_OVERALL
0,1631,4622,6253,0.009432216426282978,0.02144292017128356,0.016209476309226933
1,1054,1830,2884,0.006095374686267479,0.008489948921126983,0.007476112214266827
2,1795,850,2645,0.010380642848055148,0.003943418897791221,0.006856559225636532
3,1073,1564,2637,0.0062052533570825475,0.007255890771935848,0.006835821050284891
4,1218,1222,2440,0.007043801108039649,0.005669244580118674,0.006325143482250714
5,1874,407,2281,0.010837506795128326,0.0018882017545894436,0.005912972247136836
6,499,1327,1826,0.0028857608808799547,0.006156372796904648,0.004733488524012215
7,799,984,1783,0.0046206872621705085,0.004565087288737132,0.00462202083149714
8,810,969,1779,0.004684301229484496,0.004495497543481992,0.00461165174382132
9,980,766,1746,0.005667426178882476,0.003553716324362442,0.004526106770495798
10,543,1174,1717,0.0031402167501359025,0.005446557395302228,0.004450930884846097
11,772,925,1697,0.004464543887854359,0.004291367624066918,0.004399085446466992
12,513,1157,1670,0.0029667241120068474,0.005367689017346404,0.0043290941046552015
13,530,1023,1553,0.0030650366069466454,0.004746020626400493,0.004025798290137442
14,1252,229,1481,0.007240426097919245,0.0010624034442284584,0.003839154711972667
15,590,875,1465,0.003412021883204756,0.004059401806549787,0.003797678361269384
16,954,416,1370,0.005517065892503961,0.0019299556017425272,0.0035514125289686387
17,1422,50,1472,0.008223551047317226,0.00023196581751713067,0.0038158242647020704
18,745,626,1371,0.004308400513538209,0.002904212035314476,0.003554004800887594
19,1260,201,1461,0.007286690801420326,0.0009325025864188653,0.0037873092735935627
20,480,805,1285,0.0027758822100648864,0.003734649662025804,0.0033310694158574456
21,1135,183,1318,0.006563804809215929,0.0008489948921126983,0.0034166143891829676
22,8,1161,1169,4.6264703501081435e-05,0.005386246282747774,0.0030303658732586413
23,608,531,1139,0.0035161174660821894,0.0024634769820319276,0.002952597715689985
24,422,641,1063,0.002440463109682046,0.0029738017805696153,0.002755585049849389
25,491,554,1045,0.0028394961773788733,0.0025701812580898077,0.0027089241553081953
26,265,784,1049,0.0015325183034733227,0.003637224018668609,0.002719293242984016
27,759,238,997,0.004389363744665102,0.001104157291381542,0.0025844951031983453
28,72,951,1023,0.00041638233150973294,0.004411989849175826,0.0026518941730911804
29,375,648,1023,0.0021686579766131923,0.0030062769950220136,0.0026518941730911804
30,666,281,947,0.00385153656646503,0.0013036478944462744,0.0024548815072505848
31,389,638,1027,0.002249621207740085,0.0029598838315185875,0.0026622632607670015
32,401,594,995,0.002319018262991707,0.0027557539121035126,0.0025793105593604347
33,305,701,1006,0.0017638418209787298,0.003252160761590172,0.002607825550468942
34,372,656,1028,0.002151308712800287,0.0030433915258247543,0.002664855532685957
35,451,533,984,0.002608172659873466,0.002472755614732613,0.0025507955682519275
36,378,535,913,0.002186007240426098,0.0024820342474332984,0.0023667442620061074
37,278,610,888,0.00160769844666258,0.002829982973708994,0.002301937464032227
38,640,188,828,0.003701176280086515,0.0008721914738644114,0.0021464011488949147
39,594,308,902,0.0034351542349552967,0.001428909435905525,0.0023382292708976
40,755,119,874,0.004366231392914561,0.000552078645690771,0.002265645657166854
41,801,55,856,0.004632253438045779,0.00025516239926884376,0.0022189847626256603
42,391,506,897,0.002261187383615355,0.0023474940732733625,0.0023252679113028242
43,381,517,898,0.0022033565042390035,0.002398526553127131,0.002327860183221779
44,151,711,862,0.0008732462785829121,0.003298553925093598,0.0022345383941393916
45,243,570,813,0.0014052903688453486,0.0026444103196952896,0.0021075170701105863
46,69,783,852,0.0003990330676968274,0.0036325847023182664,0.0022086156749498397
47,388,368,756,0.00224383811980245,0.0017072684169260818,0.0019597575707301393
48,452,429,881,0.002613955747811101,0.001990266714296981,0.0022837915605995406
49,269,582,851,0.0015556506552238632,0.002700082115899401,0.0022060234030308844
50,644,222,866,0.0037243086318370557,0.0010299282297760602,0.0022449074818152123
51,393,412,805,0.0022727535594906255,0.0019113983363411567,0.0020867788947589445
52,105,688,793,0.0006072242334516939,0.003191849649035718,0.002055671631731482
53,132,696,828,0.0007633676077678437,0.003228964179838459,0.0021464011488949147
54,252,543,795,0.0014573381602840652,0.002519148778236039,0.0020608561755693926
55,82,714,796,0.0004742132108860847,0.003312471874144626,0.002063448447488348
56,87,685,772,0.0005031286505742606,0.00317793169998469,0.002001233921433423
57,414,386,800,0.0023941984061809645,0.0017907761112322489,0.0020738175351641686
58,201,550,751,0.001162400675464671,0.0025516239926884374,0.0019467962111353633
59,478,281,759,0.0027643160341896157,0.0013036478944462744,0.001967534386487005
60,98,623,721,0.0005667426178882476,0.002890294086263448,0.0018690280535667069
61,342,406,748,0.0019778160746712313,0.0018835624382391011,0.0019390193953784977
62,477,196,673,0.0027585329462519806,0.0009093060046671522,0.0017445990014568569
63,358,394,752,0.0020703454816733942,0.0018278906420349898,0.0019493884830543184
64,322,411,733,0.0018621543159185279,0.0019067590199908142,0.0019001353165941696
65,461,282,743,0.0026660035392498177,0.001308287210796617,0.0019260580357837215
66,449,269,718,0.0025966064839981957,0.0012479760982421631,0.0018612512378098412
67,521,163,684,0.0030129888155079284,0.000756208565105846,0.001773113992565364
68,470,266,736,0.0027180513306885343,0.0012340581491911353,0.0019079121323510352
69,431,280,711,0.0024925109011207625,0.0012990085780959317,0.001843105334377155
70,60,569,629,0.0003469852762581108,0.002639771003344947,0.0016305390370228276
71,535,223,758,0.003093952046634821,0.001034567546126403,0.00196494211456805
72,241,384,625,0.0013937241929700783,0.0017814974785315635,0.0016201699493470067
73,362,303,665,0.002093477833423935,0.0014057128541538118,0.001723860826105215
74,273,382,655,0.001578783006974404,0.0017722188458308783,0.001697938106915663
75,259,399,658,0.0014978197758475115,0.0018510872237867029,0.0017057149226725288
76,483,145,628,0.002793231473877792,0.0006727008707996789,0.0016279467651038723
77,129,507,636,0.0007460183439549382,0.002352133389623705,0.0016486849404555141
78,44,639,683,0.00025445586925594793,0.00296452314786893,0.001770521720646409
79,341,250,591,0.001972032986733596,0.0011598290875856534,0.0015320327041025295
80,184,396,580,0.001064088180524873,0.001837169274735675,0.0015035177129940221
81,312,277,589,0.0018043234365421761,0.0012850906290449039,0.0015268481602646192
82,379,260,639,0.0021917903283637332,0.0012062222510890795,0.0016564617562123797
83,456,162,618,0.002637088099561642,0.0007515692487555034,0.0016020240459143202
84,137,424,561,0.0007922830474560197,0.001967070132545268,0.0014542645465338733
85,478,170,648,0.0027643160341896157,0.0007886837795582443,0.0016797922034829766
86,525,60,585,0.0030361211672584694,0.0002783589810205568,0.0015164790725887983
87,414,191,605,0.0023941984061809645,0.0008861094229154392,0.0015683245109679024
88,182,397,579,0.0010525220046496027,0.0018418085910860175,0.001500925441075067
89,407,202,609,0.002353716790617518,0.000937141902769208,0.0015786935986437233
90,262,318,580,0.0015151690396604171,0.001475302599408951,0.0015035177129940221
91,188,354,542,0.0010872205322754137,0.0016423179880212851,0.0014050113800737243
92,264,285,549,0.0015267352155356874,0.0013222051598476448,0.0014231572835064106
93,294,277,571,0.0017002278536647427,0.0012850906290449039,0.0014801872657234252
94,441,109,550,0.0025503417804971142,0.0005056854821873449,0.0014257495554253659
95,349,185,534,0.0020182976902346776,0.0008582735248133835,0.0013842732047220825
96,446,152,598,0.0025792572201852903,0.0007051760852520773,0.001550178607535216
97,551,32,583,0.003186481453636984,0.00014845812321096364,0.001511294528750888
98,113,442,555,0.0006534889369527753,0.002050577826851435,0.0014387109150201418
99,352,184,536,0.0020356469540475835,0.0008536342084630409,0.001389457748559993
100,123,426,549,0.0007113198163291271,0.001976348765245953,0.0014231572835064106
101,128,402,530,0.000740235256017303,0.0018650051728377305,0.0013739041170462616
102,477,72,549,0.0027585329462519806,0.00033403077722466817,0.0014231572835064106
103,56,500,556,0.00032385292450757007,0.0023196581751713068,0.0014413031869390971
104,91,469,560,0.0005262610023248014,0.002175839368310686,0.001451672274614918
105,79,447,526,0.0004568639470731792,0.0020737744086031483,0.001363535029370441
106,100,366,466,0.000578308793763518,0.0016979897842253967,0.0012079987142331282
107,223,336,559,0.0012896286100926452,0.001558810293715118,0.0014490800026959628
108,343,198,541,0.0019835991626088664,0.0009185846373678375,0.001402419108154769
109,78,462,540,0.00045108085913554404,0.0021433641538582873,0.0013998268362358137
110,395,139,534,0.002284319735365896,0.0006448649726976233,0.0013842732047220825
111,470,92,562,0.0027180513306885343,0.00042681710423152046,0.0014568568184528284
112,67,471,538,0.000387466891821557,0.002185118001011371,0.0013946422923979034
113,133,360,493,0.0007691506957054789,0.001670153886123341,0.0012779900560449188
114,274,278,552,0.0015845660949120393,0.0012897299453952466,0.0014309340992632762
115,41,477,518,0.00023710660544304236,0.0022129538991134266,0.001342796854018799
116,64,461,525,0.0003701176280086515,0.0021387248375079448,0.0013609427574514856
117,59,421,480,0.0003412021883204756,0.0019531521834942403,0.001244290521098501
118,160,334,494,0.0009252940700216288,0.001549531661014433,0.001280582327963874
119,137,380,517,0.0007922830474560197,0.0017629402131301931,0.001340204582099844
120,142,354,496,0.0008211984871441955,0.0016423179880212851,0.0012857668718017844
121,134,389,523,0.000774933783643114,0.0018046940602832766,0.0013557582136135753
122,302,189,491,0.0017464925571658242,0.000876830790214754,0.0012728055122070085
123,141,387,528,0.0008154153992065604,0.0017954154275825914,0.0013687195732083512
124,369,161,530,0.0021339594489873815,0.0007469299324051608,0.0013739041170462616
125,213,267,480,0.0012317977307162932,0.0012386974655414777,0.001244290521098501
126,323,173,496,0.001867937403856163,0.0008026017286092721,0.0012857668718017844
127,50,430,480,0.000289154396881759,0.001994906030647324,0.001244290521098501
128,286,190,476,0.0016539631501636613,0.0008814701065650966,0.0012339214334226804
129,219,197,416,0.0012664962583421044,0.0009139453210174949,0.0010783851182853677
130,164,315,479,0.0009484264217721694,0.0014613846503579231,0.001241698249179546
131,50,427,477,0.000289154396881759,0.001980988081596296,0.0012365137053416354
132,46,359,405,0.00026602204513121824,0.0016655145697729982,0.0010498701271768602
133,118,352,470,0.0006824043766409512,0.0016330393553206,0.0012183678019089491
134,335,151,486,0.0019373344591077852,0.0007005367689017347,0.0012598441526122325
135,206,260,466,0.001191316115152847,0.0012062222510890795,0.0012079987142331282
136,200,236,436,0.001156617587527036,0.0010948786586808567,0.001130230556664472
137,116,372,488,0.0006708382007656809,0.0017258256823274522,0.0012650286964501429
138,52,400,452,0.00030072057275702934,0.0018557265401370454,0.0011717069073677552
139,245,267,512,0.001416856544720619,0.0012386974655414777,0.0013272432225050678
140,211,233,444,0.001220231554841023,0.001080960709629829,0.0011509687320161136
141,295,170,465,0.001706010941602378,0.0007886837795582443,0.001205406442314173
142,355,125,480,0.002052996217860489,0.0005799145437928267,0.001244290521098501
143,362,43,405,0.002093477833423935,0.00019949060306473238,0.0010498701271768602
144,390,54,444,0.00225540429567772,0.0002505230829185011,0.0011509687320161136
145,106,316,422,0.000613007321389329,0.0014660239667082658,0.001093938749799099
146,251,191,442,0.00145155507234643,0.0008861094229154392,0.0011457841881782032
147,88,348,436,0.0005089117385118959,0.0016144820899192296,0.001130230556664472
148,205,212,417,0.0011855330272152118,0.000983535066272634,0.001080977390204323
149,366,61,427,0.0021166101851744757,0.0002829982973708994,0.0011069001093938749
150,62,372,434,0.00035855145213338117,0.0017258256823274522,0.0011250460128265614
151,261,196,457,0.001509385951722782,0.0009093060046671522,0.0011846682669625313
152,159,302,461,0.0009195109820839936,0.0014010735378034694,0.0011950373546383522
153,219,229,448,0.0012664962583421044,0.0010624034442284584,0.0011613378196919345
154,160,242,402,0.0009252940700216288,0.0011227145567829124,0.0010420933114199946
155,262,171,433,0.0015151690396604171,0.0007933230959085869,0.0011224537409076061
156,100,312,412,0.000578308793763518,0.0014474667013068955,0.0010680160306095468
157,269,167,436,0.0015556506552238632,0.0007747658305072165,0.001130230556664472
158,122,301,423,0.000705536728391492,0.0013964342214531267,0.0010965310217180542
159,177,245,422,0.0010236065649614269,0.0011366325058339403,0.001093938749799099
160,357,53,410,0.002064562393735759,0.0002458837665681585,0.0010628314867716364
161,342,84,426,0.0019778160746712313,0.0003897025734287795,0.0011043078374749198
162,121,294,415,0.0006997536404538567,0.0013639590070007284,0.0010757928463664124
163,342,85,427,0.0019778160746712313,0.00039434188977912216,0.0011069001093938749
164,104,294,398,0.0006014411455140587,0.0013639590070007284,0.001031724223744174
165,73,377,450,0.0004221654194473681,0.0017490222640791653,0.0011665223635298448
166,189,203,392,0.001093003620213049,0.0009417812191195506,0.0010161705922304427
167,216,207,423,0.0012491469945291988,0.000960338484520921,0.0010965310217180542
168,41,370,411,0.00023710660544304236,0.001716547049626767,0.0010654237586905917
169,93,346,439,0.0005378271782000717,0.0016052034572185442,0.0011380073724213376
170,368,54,422,0.002128176361049746,0.0002505230829185011,0.001093938749799099
171,208,111,319,0.0012028822910281174,0.0005149641148880301,0.0008269347421467122
172,223,181,404,0.0012896286100926452,0.000839716259412013,0.0010472778552579052
173,175,202,377,0.0010120403890861564,0.000937141902769208,0.0009772865134461144
174,190,208,398,0.0010987867081506842,0.0009649778008712636,0.001031724223744174
175,364,72,436,0.0021050440092992054,0.00033403077722466817,0.001130230556664472
176,198,199,397,0.0011450514116517656,0.0009232239537181801,0.0010291319518252187
177,156,231,387,0.0009021617182710881,0.0010716820769291436,0.0010032092326356665
178,280,135,415,0.0016192646225378503,0.0006263077072962528,0.0010757928463664124
179,288,112,400,0.0016655293260389318,0.0005196034312383727,0.0010369087675820843
180,222,195,417,0.0012838455221550098,0.0009046666883168096,0.001080977390204323
181,202,199,401,0.0011681837634023064,0.0009232239537181801,0.0010395010395010396
182,187,149,336,0.0010814374443377786,0.0006912581362010494,0.0008710033647689508
183,136,253,389,0.0007864999595183844,0.0011737470366366813,0.001008393776473577
184,74,296,370,0.0004279485073850033,0.0013732376397014136,0.0009591406100134279
185,89,308,397,0.000514694826449531,0.001428909435905525,0.0010291319518252187
186,293,89,382,0.0016944447657271076,0.0004128991551804926,0.0009902478730408905
187,107,250,357,0.0006187904093269642,0.0011598290875856534,0.0009254410750670103
188,145,227,372,0.000838547750957101,0.0010531248115277733,0.0009643251538513384
189,133,267,400,0.0007691506957054789,0.0012386974655414777,0.0010369087675820843
190,311,79,390,0.0017985403486045408,0.00036650599167706646,0.0010109860483925321
191,4,367,371,2.3132351750540717e-05,0.0017026291005757391,0.0009617328819323832
192,44,288,332,0.00025445586925594793,0.0013361231088986727,0.00086063427709313
193,270,148,418,0.0015614337431614986,0.0006866188198507068,0.001083569662123278
194,209,200,409,0.0012086653789657525,0.0009278632700685227,0.0010602392148526811
195,111,251,362,0.0006419227610775049,0.001164468403935996,0.0009384024346617862
196,118,261,379,0.0006824043766409512,0.0012108615674394222,0.000982471057284025
197,369,14,383,0.0021339594489873815,6.495042890479659e-05,0.0009928401449598456
198,91,272,363,0.0005262610023248014,0.0012618940472931908,0.0009409947065807415
199,144,196,340,0.0008327646630194659,0.0009093060046671522,0.0008813724524447716
200,145,217,362,0.000838547750957101,0.0010067316480243471,0.0009384024346617862
201,244,129,373,0.001411073456782984,0.0005984718091941972,0.0009669174257702936
202,165,217,382,0.0009542095097098047,0.0010067316480243471,0.0009902478730408905
203,275,91,366,0.0015903491828496744,0.0004221777878811778,0.0009487715223376071
204,251,85,336,0.00145155507234643,0.00039434188977912216,0.0008710033647689508
205,489,14,503,0.002827930001503603,6.495042890479659e-05,0.001303912775234471
206,111,232,343,0.0006419227610775049,0.0010763213932794863,0.0008891492682016373
207,85,286,371,0.0004915624746989903,0.0013268444761979875,0.0009617328819323832
208,88,250,338,0.0005089117385118959,0.0011598290875856534,0.0008761879086068613
209,251,116,367,0.00145155507234643,0.0005381606966397432,0.0009513637942565623
210,139,202,341,0.00080384922333129,0.000937141902769208,0.0008839647243637269
211,211,167,378,0.001220231554841023,0.0007747658305072165,0.0009798787853650696
212,99,285,384,0.0005725257058258828,0.0013222051598476448,0.0009954324168788009
213,199,191,390,0.0011508344995894008,0.0008861094229154392,0.0010109860483925321
214,142,206,348,0.0008211984871441955,0.0009556991681705783,0.0009021106277964133
215,81,233,314,0.00046843012294844953,0.001080960709629829,0.0008139733825519362
216,41,310,351,0.00023710660544304236,0.00143818806860621,0.0009098874435532789
217,79,286,365,0.0004568639470731792,0.0013268444761979875,0.0009461792504186519
218,143,218,361,0.0008269815750818306,0.0010113709643746898,0.0009358101627428311
219,116,251,367,0.0006708382007656809,0.001164468403935996,0.0009513637942565623
220,89,271,360,0.000514694826449531,0.0012572547309428483,0.0009332178908238759
221,110,232,342,0.0006361396731398698,0.0010763213932794863,0.000886556996282682
222,313,66,379,0.0018101065244798113,0.00030619487912261246,0.000982471057284025
223,328,67,395,0.0018968528435443389,0.0003108341954729551,0.0010239474079873083
224,96,242,338,0.0005551764420129772,0.0011227145567829124,0.0008761879086068613
225,262,63,325,0.0015151690396604171,0.00029227693007158464,0.0008424883736604435
226,52,298,350,0.00030072057275702934,0.0013825162724020988,0.0009072951716343237
227,289,83,372,0.0016713124139765669,0.00038506325707843693,0.0009643251538513384
228,158,193,351,0.0009137278941463584,0.0008953880556161244,0.0009098874435532789
229,118,216,334,0.0006824043766409512,0.0010020923316740045,0.0008658188209310403
230,289,57,346,0.0016713124139765669,0.000264441031969529,0.000896926083958503
231,284,47,331,0.001642396974288391,0.00021804786846610285,0.0008580420051741747
232,97,241,338,0.0005609595299506125,0.00111807524043257,0.0008761879086068613
233,2,345,347,1.1566175875270359e-05,0.0016005641408682017,0.0008995183558774581
234,136,192,328,0.0007864999595183844,0.0008907487392657817,0.0008502651894173091
235,143,198,341,0.0008269815750818306,0.0009185846373678375,0.0008839647243637269
236,247,97,344,0.0014284227205958893,0.0004500136859832335,0.0008917415401205925
237,84,240,324,0.0004857793867613551,0.0011134359240822273,0.0008398961017414883
238,204,128,332,0.0011797499392775766,0.0005938324928438546,0.00086063427709313
239,119,214,333,0.0006881874645785864,0.0009928136989733193,0.0008632265490120852
240,248,75,323,0.0014342058085335247,0.000347948726275696,0.000837303829822533
241,185,138,323,0.0010698712684625083,0.0006402256563472807,0.000837303829822533
242,248,75,323,0.0014342058085335247,0.000347948726275696,0.000837303829822533
243,140,194,334,0.0008096323112689251,0.000900027371966467,0.0008658188209310403
244,97,216,313,0.0005609595299506125,0.0010020923316740045,0.000811381110632981
245,259,32,291,0.0014978197758475115,0.00014845812321096364,0.0007543511284159663
246,161,153,314,0.0009310771579592639,0.0007098154016024199,0.0008139733825519362
247,79,251,330,0.0004568639470731792,0.001164468403935996,0.0008554497332552196
248,212,93,305,0.001226014642778658,0.00043145642058186305,0.0007906429352813393
249,242,72,314,0.0013995072809077135,0.00033403077722466817,0.0008139733825519362
250,260,54,314,0.0015036028637851466,0.0002505230829185011,0.0008139733825519362
251,67,268,335,0.000387466891821557,0.0012433367818918204,0.0008684110928499956
252,114,189,303,0.0006592720248904105,0.000876830790214754,0.0007854583914434288
253,22,276,298,0.00012722793462797397,0.0012804513126945614,0.0007724970318486528
254,143,162,305,0.0008269815750818306,0.0007515692487555034,0.0007906429352813393
255,309,39,348,0.0017869741727292705,0.00018093333766336194,0.0009021106277964133
256,104,197,301,0.0006014411455140587,0.0009139453210174949,0.0007802738476055184
257,181,117,298,0.0010467389167119676,0.0005428000129900858,0.0007724970318486528
258,217,90,307,0.001254930082466834,0.0004175384715308352,0.0007958274791192497
259,10,318,328,5.78308793763518e-05,0.001475302599408951,0.0008502651894173091
260,146,180,326,0.0008443308388947362,0.0008350769430616704,0.0008450806455793986
261,189,131,320,0.001093003620213049,0.0006077504418948823,0.0008295270140656674
262,261,61,322,0.001509385951722782,0.0002829982973708994,0.0008347115579035779
263,230,104,334,0.0013301102256560913,0.0004824889004356318,0.0008658188209310403
264,148,148,296,0.0008558970147700066,0.0006866188198507068,0.0007673124880107424
265,169,114,283,0.0009773418614603454,0.000528882063939058,0.0007336129530643246
266,14,302,316,8.096323112689252e-05,0.0014010735378034694,0.0008191579263898466
267,188,112,300,0.0010872205322754137,0.0005196034312383727,0.0007776815756865632
268,175,112,287,0.0010120403890861564,0.0005196034312383727,0.0007439820407401454
269,266,43,309,0.0015383013914109578,0.00019949060306473238,0.0008010120229571601
270,214,99,313,0.0012375808186539283,0.00045929231868391875,0.000811381110632981
271,264,55,319,0.0015267352155356874,0.00025516239926884376,0.0008269347421467122
272,140,172,312,0.0008096323112689251,0.0007979624122589295,0.0008087888387140257
273,123,173,296,0.0007113198163291271,0.0008026017286092721,0.0007673124880107424
274,266,24,290,0.0015383013914109578,0.00011134359240822272,0.0007517588564970111
275,75,207,282,0.0004337315953226385,0.000960338484520921,0.0007310206811453695
276,89,212,301,0.000514694826449531,0.000983535066272634,0.0007802738476055184
277,131,171,302,0.0007575845198302086,0.0007933230959085869,0.0007828661195244737
278,105,167,272,0.0006072242334516939,0.0007747658305072165,0.0007050979619558173
279,143,157,300,0.0008269815750818306,0.0007283726670037903,0.0007776815756865632
280,3,281,284,1.7349263812905538e-05,0.0013036478944462744,0.0007362052249832798
281,45,252,297,0.00026023895719358306,0.0011691077202863386,0.0007699047599296976
282,102,200,302,0.0005898749696387883,0.0009278632700685227,0.0007828661195244737
283,65,212,277,0.00037590071594628666,0.000983535066272634,0.0007180593215505934
284,53,243,296,0.0003065036606946645,0.0011273538731332551,0.0007673124880107424
285,137,150,287,0.0007922830474560197,0.000695897452551392,0.0007439820407401454
286,200,81,281,0.001156617587527036,0.0003757846243777517,0.0007284284092264142
287,167,114,281,0.000965775685585075,0.000528882063939058,0.0007284284092264142
288,96,168,264,0.0005551764420129772,0.000779405146857559,0.0006843597866041756
289,28,265,293,0.00016192646225378504,0.0012294188328407926,0.0007595356722538768
290,33,260,293,0.00019084190194196092,0.0012062222510890795,0.0007595356722538768
291,114,182,296,0.0006592720248904105,0.0008443555757623556,0.0007673124880107424
292,146,152,298,0.0008443308388947362,0.0007051760852520773,0.0007724970318486528
293,154,133,287,0.0008905955423958177,0.0006170290745955676,0.0007439820407401454
294,1,316,317,5.783087937635179e-06,0.0014660239667082658,0.0008217501983088018
295,62,238,300,0.00035855145213338117,0.001104157291381542,0.0007776815756865632
296,187,90,277,0.0010814374443377786,0.0004175384715308352,0.0007180593215505934
297,77,200,277,0.00044529777119790885,0.0009278632700685227,0.0007180593215505934
298,188,102,290,0.0010872205322754137,0.0004732102677349466,0.0007517588564970111
299,108,151,259,0.0006245734972645994,0.0007005367689017347,0.0006713984270093995
300,235,24,259,0.0013590256653442671,0.00011134359240822272,0.0006713984270093995
301,259,41,300,0.0014978197758475115,0.00019021197036404714,0.0007776815756865632
302,22,229,251,0.00012722793462797397,0.0010624034442284584,0.0006506602516577578
303,158,104,262,0.0009137278941463584,0.0004824889004356318,0.0006791752427662652
304,137,151,288,0.0007922830474560197,0.0007005367689017347,0.0007465743126591007
305,73,182,255,0.0004221654194473681,0.0008443555757623556,0.0006610293393335787
306,171,90,261,0.0009889080373356157,0.0004175384715308352,0.00067658297084731
307,261,32,293,0.001509385951722782,0.00014845812321096364,0.0007595356722538768
308,89,193,282,0.000514694826449531,0.0008953880556161244,0.0007310206811453695
309,88,188,276,0.0005089117385118959,0.0008721914738644114,0.0007154670496316381
310,79,189,268,0.0004568639470731792,0.000876830790214754,0.0006947288742799965
311,251,32,283,0.00145155507234643,0.00014845812321096364,0.0007336129530643246
312,231,52,283,0.0013358933135937266,0.0002412444502178159,0.0007336129530643246
313,43,228,271,0.00024867278131831275,0.001057764127878116,0.0007025056900368621
314,60,202,262,0.0003469852762581108,0.000937141902769208,0.0006791752427662652
315,182,79,261,0.0010525220046496027,0.00036650599167706646,0.00067658297084731
316,115,164,279,0.0006650551128280456,0.0007608478814561886,0.0007232438653885038
317,185,76,261,0.0010698712684625083,0.00035258804262603864,0.00067658297084731
318,1,276,277,5.783087937635179e-06,0.0012804513126945614,0.0007180593215505934
319,140,111,251,0.0008096323112689251,0.0005149641148880301,0.0006506602516577578
320,126,138,264,0.0007286690801420326,0.0006402256563472807,0.0006843597866041756
321,130,143,273,0.0007518014318925733,0.0006634222380989937,0.0007076902338747725
322,52,215,267,0.00030072057275702934,0.000997453015323662,0.0006921366023610412
323,101,175,276,0.0005840918817011532,0.0008118803613099574,0.0007154670496316381
324,189,71,260,0.001093003620213049,0.0003293914608743256,0.0006739906989283548
325,103,127,230,0.0005956580575764235,0.0005891931764935119,0.0005962225413596985
326,246,31,277,0.0014226396326582542,0.00014381880686062103,0.0007180593215505934
327,109,162,271,0.0006303565852022345,0.0007515692487555034,0.0007025056900368621
328,72,226,298,0.00041638233150973294,0.0010484854951774306,0.0007724970318486528
329,184,75,259,0.001064088180524873,0.000347948726275696,0.0006713984270093995
330,110,140,250,0.0006361396731398698,0.0006495042890479659,0.0006480679797388027
331,112,180,292,0.0006477058490151401,0.0008350769430616704,0.0007569434003349215
332,78,210,288,0.00045108085913554404,0.0009742564335719488,0.0007465743126591007
333,111,170,281,0.0006419227610775049,0.0007886837795582443,0.0007284284092264142
334,83,136,219,0.0004799962988237199,0.0006309470236465954,0.0005677075502511912
335,125,134,259,0.0007228859922043975,0.0006216683909459102,0.0006713984270093995
336,180,56,236,0.0010409558287743322,0.00025980171561918635,0.0006117761728734297
337,136,104,240,0.0007864999595183844,0.0004824889004356318,0.0006221452605492505
338,85,159,244,0.0004915624746989903,0.0007376512997044755,0.0006325143482250714
339,109,126,235,0.0006303565852022345,0.0005845538601431693,0.0006091839009544746
340,66,185,251,0.00038168380388392184,0.0008582735248133835,0.0006506602516577578
341,20,225,245,0.0001156617587527036,0.001043846178827088,0.0006351066201440266
342,42,178,220,0.00024288969338067754,0.0008257983103609852,0.0005702998221701463
343,33,199,232,0.00019084190194196092,0.0009232239537181801,0.0006014070851976089
344,111,158,269,0.0006419227610775049,0.0007330119833541329,0.0006973211461989517
345,137,108,245,0.0007922830474560197,0.0005010461658370022,0.0006351066201440266
346,10,251,261,5.78308793763518e-05,0.001164468403935996,0.00067658297084731
347,28,220,248,0.00016192646225378504,0.001020649597075375,0.0006428834359008922
348,134,132,266,0.000774933783643114,0.0006123897582452249,0.0006895443304420861
349,130,105,235,0.0007518014318925733,0.0004871282167859744,0.0006091839009544746
350,139,120,259,0.00080384922333129,0.0005567179620411136,0.0006713984270093995
351,74,166,240,0.0004279485073850033,0.0007701265141568739,0.0006221452605492505
352,86,133,219,0.0004973455626366255,0.0006170290745955676,0.0005677075502511912
353,148,113,261,0.0008558970147700066,0.0005242427475887153,0.00067658297084731
354,1,249,250,5.783087937635179e-06,0.0011551897712353107,0.0006480679797388027
355,150,83,233,0.000867463190645277,0.00038506325707843693,0.0006039993571165641
356,91,159,250,0.0005262610023248014,0.0007376512997044755,0.0006480679797388027
357,146,89,235,0.0008443308388947362,0.0004128991551804926,0.0006091839009544746
358,112,133,245,0.0006477058490151401,0.0006170290745955676,0.0006351066201440266
359,34,203,237,0.0001966249898795961,0.0009417812191195506,0.0006143684447923849
360,37,211,248,0.00021397425369250165,0.0009788957499222914,0.0006428834359008922
361,28,221,249,0.00016192646225378504,0.0010252889134257175,0.0006454757078198475
362,115,122,237,0.0006650551128280456,0.0005659965947417988,0.0006143684447923849
363,248,18,266,0.0014342058085335247,8.350769430616704e-05,0.0006895443304420861
364,65,176,241,0.00037590071594628666,0.0008165196776603,0.0006247375324682058
365,169,77,246,0.0009773418614603454,0.00035722735897638123,0.0006376988920629819
366,141,105,246,0.0008154153992065604,0.0004871282167859744,0.0006376988920629819
367,1,253,254,5.783087937635179e-06,0.0011737470366366813,0.0006584370674146236
368,121,116,237,0.0006997536404538567,0.0005381606966397432,0.0006143684447923849
369,100,128,228,0.000578308793763518,0.0005938324928438546,0.000591037997521788
370,126,126,252,0.0007286690801420326,0.0005845538601431693,0.0006532525235767131
371,162,54,216,0.0009368602458968991,0.0002505230829185011,0.0005599307344943255
372,111,129,240,0.0006419227610775049,0.0005984718091941972,0.0006221452605492505
373,128,113,241,0.000740235256017303,0.0005242427475887153,0.0006247375324682058
374,112,127,239,0.0006477058490151401,0.0005891931764935119,0.0006195529886302954
375,1,215,216,5.783087937635179e-06,0.000997453015323662,0.0005599307344943255
376,135,109,244,0.0007807168715807493,0.0005056854821873449,0.0006325143482250714
377,181,69,250,0.0010467389167119676,0.00032011282817364034,0.0006480679797388027
378,61,193,254,0.000352768364195746,0.0008953880556161244,0.0006584370674146236
379,40,195,235,0.0002313235175054072,0.0009046666883168096,0.0006091839009544746
380,243,13,256,0.0014052903688453486,6.0311112554453976e-05,0.0006636216112525339
381,69,167,236,0.0003990330676968274,0.0007747658305072165,0.0006117761728734297
382,40,188,228,0.0002313235175054072,0.0008721914738644114,0.000591037997521788
383,33,167,200,0.00019084190194196092,0.0007747658305072165,0.0005184543837910421
384,1,224,225,5.783087937635179e-06,0.0010392068624767454,0.0005832611817649224
385,193,76,269,0.0011161359719635898,0.00035258804262603864,0.0006973211461989517
386,147,59,206,0.0008501139268323714,0.00027371966467021417,0.0005340080153047734
387,62,187,249,0.00035855145213338117,0.0008675521575140687,0.0006454757078198475
388,87,157,244,0.0005031286505742606,0.0007283726670037903,0.0006325143482250714
389,179,46,225,0.0010351727408366971,0.00021340855211576023,0.0005832611817649224
390,95,154,249,0.0005493933540753421,0.0007144547179527625,0.0006454757078198475
391,20,180,200,0.0001156617587527036,0.0008350769430616704,0.0005184543837910421
392,160,59,219,0.0009252940700216288,0.00027371966467021417,0.0005677075502511912
393,145,76,221,0.000838547750957101,0.00035258804262603864,0.0005728920940891016
394,51,169,220,0.00029493748481939416,0.0007840444632079016,0.0005702998221701463
395,69,175,244,0.0003990330676968274,0.0008118803613099574,0.0006325143482250714
396,2,247,249,1.1566175875270359e-05,0.0011459111385346255,0.0006454757078198475
397,73,137,210,0.0004221654194473681,0.0006355863399969381,0.0005443771029805943
398,36,177,213,0.00020819116575486647,0.0008211589940106426,0.0005521539187374599
399,40,222,262,0.0002313235175054072,0.0010299282297760602,0.0006791752427662652
400,207,5,212,0.0011970992030904822,2.319658175171307e-05,0.0005495616468185046
401,184,39,223,0.001064088180524873,0.00018093333766336194,0.000578076637927012
402,198,52,250,0.0011450514116517656,0.0002412444502178159,0.0006480679797388027
403,117,100,217,0.000676621288703316,0.00046393163503426134,0.0005625230064132807
404,104,126,230,0.0006014411455140587,0.0005845538601431693,0.0005962225413596985
405,31,172,203,0.00017927572606669058,0.0007979624122589295,0.0005262311995479078
406,116,116,232,0.0006708382007656809,0.0005381606966397432,0.0006014070851976089
407,142,111,253,0.0008211984871441955,0.0005149641148880301,0.0006558447954956683
408,210,3,213,0.0012144484669033878,1.391794905102784e-05,0.0005521539187374599
409,144,86,230,0.0008327646630194659,0.00039898120612946476,0.0005962225413596985
410,115,82,197,0.0006650551128280456,0.0003804239407280943,0.0005106775680341765
411,22,203,225,0.00012722793462797397,0.0009417812191195506,0.0005832611817649224
412,186,44,230,0.0010756543564001434,0.000204129919415075,0.0005962225413596985
413,80,145,225,0.0004626470350108144,0.0006727008707996789,0.0005832611817649224
414,29,263,292,0.00016770955019142022,0.0012201402001401074,0.0007569434003349215
415,148,82,230,0.0008558970147700066,0.0003804239407280943,0.0005962225413596985
416,71,134,205,0.00041059924357209776,0.0006216683909459102,0.0005314157433858182
417,116,117,233,0.0006708382007656809,0.0005428000129900858,0.0006039993571165641
418,134,80,214,0.000774933783643114,0.0003711453080274091,0.0005547461906564151
419,26,172,198,0.00015036028637851467,0.0007979624122589295,0.0005132698399531317
420,108,112,220,0.0006245734972645994,0.0005196034312383727,0.0005702998221701463
421,149,58,207,0.0008616801027076417,0.0002690803483198716,0.0005366002872237287
422,35,169,204,0.0002024080778172313,0.0007840444632079016,0.0005288234714668629
423,175,28,203,0.0010120403890861564,0.00012990085780959317,0.0005262311995479078
424,162,36,198,0.0009368602458968991,0.00016701538861233408,0.0005132698399531317
425,107,121,228,0.0006187904093269642,0.0005613572783914562,0.000591037997521788
426,85,120,205,0.0004915624746989903,0.0005567179620411136,0.0005314157433858182
427,132,88,220,0.0007633676077678437,0.00040825983883015,0.0005702998221701463
428,73,142,215,0.0004221654194473681,0.0006587829217486512,0.0005573384625753703
429,43,175,218,0.00024867278131831275,0.0008118803613099574,0.000565115278332236
430,93,128,221,0.0005378271782000717,0.0005938324928438546,0.0005728920940891016
431,141,80,221,0.0008154153992065604,0.0003711453080274091,0.0005728920940891016
432,62,157,219,0.00035855145213338117,0.0007283726670037903,0.0005677075502511912
433,39,172,211,0.00022554042956777202,0.0007979624122589295,0.0005469693748995495
434,57,154,211,0.00032963601244520525,0.0007144547179527625,0.0005469693748995495
435,93,116,209,0.0005378271782000717,0.0005381606966397432,0.000541784831061639
436,63,130,193,0.0003643345400710163,0.0006031111255445397,0.0005003084803583557
437,35,156,191,0.0002024080778172313,0.0007237333506534477,0.0004951239365204453
438,67,150,217,0.000387466891821557,0.000695897452551392,0.0005625230064132807
439,31,151,182,0.00017927572606669058,0.0007005367689017347,0.00047179348924984834
440,52,148,200,0.00030072057275702934,0.0006866188198507068,0.0005184543837910421
441,175,36,211,0.0010120403890861564,0.00016701538861233408,0.0005469693748995495
442,170,51,221,0.0009831249493979805,0.0002366051338674733,0.0005728920940891016
443,80,134,214,0.0004626470350108144,0.0006216683909459102,0.0005547461906564151
444,50,164,214,0.000289154396881759,0.0007608478814561886,0.0005547461906564151
445,91,107,198,0.0005262610023248014,0.0004964068494866596,0.0005132698399531317
446,213,50,263,0.0012317977307162932,0.00023196581751713067,0.0006817675146852204
447,158,78,236,0.0009137278941463584,0.00036186667532672387,0.0006117761728734297
448,145,62,207,0.000838547750957101,0.00028763761372124205,0.0005366002872237287
449,245,15,260,0.001416856544720619,6.95897452551392e-05,0.0006739906989283548
450,96,123,219,0.0005551764420129772,0.0005706359110921415,0.0005677075502511912
451,83,119,202,0.0004799962988237199,0.000552078645690771,0.0005236389276289526
452,85,129,214,0.0004915624746989903,0.0005984718091941972,0.0005547461906564151
453,150,85,235,0.000867463190645277,0.00039434188977912216,0.0006091839009544746
454,119,87,206,0.0006881874645785864,0.0004036205224798074,0.0005340080153047734
455,33,169,202,0.00019084190194196092,0.0007840444632079016,0.0005236389276289526
456,16,199,215,9.252940700216287e-05,0.0009232239537181801,0.0005573384625753703
457,33,174,207,0.00019084190194196092,0.0008072410449596148,0.0005366002872237287
458,91,122,213,0.0005262610023248014,0.0005659965947417988,0.0005521539187374599
459,108,77,185,0.0006245734972645994,0.00035722735897638123,0.00047957030500671397
460,78,111,189,0.00045108085913554404,0.0005149641148880301,0.0004899393926825348
461,3,168,171,1.7349263812905538e-05,0.000779405146857559,0.000443278498141341
462,174,22,196,0.0010062573011485213,0.0001020649597075375,0.0005080852961152213
463,96,96,192,0.0005551764420129772,0.0004453743696328909,0.0004977162084394004
464,77,121,198,0.00044529777119790885,0.0005613572783914562,0.0005132698399531317
465,195,29,224,0.00112770214783886,0.0001345401741599358,0.0005806689098459672
466,12,191,203,6.939705525162215e-05,0.0008861094229154392,0.0005262311995479078
467,131,86,217,0.0007575845198302086,0.00039898120612946476,0.0005625230064132807
468,143,83,226,0.0008269815750818306,0.00038506325707843693,0.0005858534536838776
469,64,138,202,0.0003701176280086515,0.0006402256563472807,0.0005236389276289526
470,198,3,201,0.0011450514116517656,1.391794905102784e-05,0.0005210466557099973
471,74,123,197,0.0004279485073850033,0.0005706359110921415,0.0005106775680341765
472,151,48,199,0.0008732462785829121,0.00022268718481644544,0.000515862111872087
473,137,79,216,0.0007922830474560197,0.00036650599167706646,0.0005599307344943255
474,175,40,215,0.0010120403890861564,0.00018557265401370455,0.0005573384625753703
475,29,146,175,0.00016770955019142022,0.0006773401871500216,0.00045364758581716187
476,99,85,184,0.0005725257058258828,0.00039434188977912216,0.0004769780330877588
477,107,107,214,0.0006187904093269642,0.0004964068494866596,0.0005547461906564151
478,22,159,181,0.00012722793462797397,0.0007376512997044755,0.0004692012173308931
479,249,19,268,0.0014399888964711598,8.814701065650966e-05,0.0006947288742799965
480,116,90,206,0.0006708382007656809,0.0004175384715308352,0.0005340080153047734
481,64,135,199,0.0003701176280086515,0.0006263077072962528,0.000515862111872087
482,138,77,215,0.0007980661353936548,0.00035722735897638123,0.0005573384625753703
483,2,207,209,1.1566175875270359e-05,0.000960338484520921,0.000541784831061639
484,171,40,211,0.0009889080373356157,0.00018557265401370455,0.0005469693748995495
485,144,46,190,0.0008327646630194659,0.00021340855211576023,0.00049253166460149
486,91,94,185,0.0005262610023248014,0.0004360957369322057,0.00047957030500671397
487,74,101,175,0.0004279485073850033,0.000468570951384604,0.00045364758581716187
488,130,43,173,0.0007518014318925733,0.00019949060306473238,0.0004484630419792515
489,87,98,185,0.0005031286505742606,0.0004546530023335761,0.00047957030500671397
490,138,56,194,0.0007980661353936548,0.00025980171561918635,0.0005029007522773109
491,148,71,219,0.0008558970147700066,0.0003293914608743256,0.0005677075502511912
492,8,176,184,4.6264703501081435e-05,0.0008165196776603,0.0004769780330877588
493,51,129,180,0.00029493748481939416,0.0005984718091941972,0.00046660894541193795
494,9,177,186,5.204779143871662e-05,0.0008211589940106426,0.0004821625769256692
495,178,28,206,0.001029389652899062,0.00012990085780959317,0.0005340080153047734
496,23,152,175,0.00013301102256560912,0.0007051760852520773,0.00045364758581716187
497,72,126,198,0.00041638233150973294,0.0005845538601431693,0.0005132698399531317
498,1,186,187,5.783087937635179e-06,0.0008629128411637261,0.0004847548488446244
499,35,156,191,0.0002024080778172313,0.0007237333506534477,0.0004951239365204453
500,47,179,226,0.0002718051330688534,0.0008304376267113279,0.0005858534536838776
501,160,44,204,0.0009252940700216288,0.000204129919415075,0.0005288234714668629
502,68,117,185,0.0003932499797591922,0.0005428000129900858,0.00047957030500671397
503,67,125,192,0.000387466891821557,0.0005799145437928267,0.0004977162084394004
504,4,193,197,2.3132351750540717e-05,0.0008953880556161244,0.0005106775680341765
505,126,68,194,0.0007286690801420326,0.0003154735118232977,0.0005029007522773109
506,62,128,190,0.00035855145213338117,0.0005938324928438546,0.00049253166460149
507,136,57,193,0.0007864999595183844,0.000264441031969529,0.0005003084803583557
508,10,201,211,5.78308793763518e-05,0.0009325025864188653,0.0005469693748995495
509,109,79,188,0.0006303565852022345,0.00036650599167706646,0.0004873471207635796
510,167,24,191,0.000965775685585075,0.00011134359240822272,0.0004951239365204453
511,75,114,189,0.0004337315953226385,0.000528882063939058,0.0004899393926825348
512,118,57,175,0.0006824043766409512,0.000264441031969529,0.00045364758581716187
513,118,51,169,0.0006824043766409512,0.0002366051338674733,0.0004380939543034306
514,151,34,185,0.0008732462785829121,0.00015773675591164885,0.00047957030500671397
515,214,12,226,0.0012375808186539283,5.567179620411136e-05,0.0005858534536838776
516,61,100,161,0.000352768364195746,0.00046393163503426134,0.0004173557789517889
517,63,132,195,0.0003643345400710163,0.0006123897582452249,0.0005054930241962661
518,4,197,201,2.3132351750540717e-05,0.0009139453210174949,0.0005210466557099973
519,136,21,157,0.0007864999595183844,9.742564335719488e-05,0.0004069866912759681
520,76,110,186,0.00043951468326027367,0.0005103247985376875,0.0004821625769256692
521,80,98,178,0.0004626470350108144,0.0004546530023335761,0.0004614244015740275
522,17,117,134,9.831249493979805e-05,0.0005428000129900858,0.00034736443713999826
523,58,123,181,0.00033541910038284044,0.0005706359110921415,0.0004692012173308931
524,7,172,179,4.048161556344626e-05,0.0007979624122589295,0.0004640166734929827
525,88,80,168,0.0005089117385118959,0.0003711453080274091,0.0004355016823844754
526,73,105,178,0.0004221654194473681,0.0004871282167859744,0.0004614244015740275
527,96,82,178,0.0005551764420129772,0.0003804239407280943,0.0004614244015740275
528,124,9,133,0.0007171029042667623,4.175384715308352e-05,0.00034477216522104304
529,104,85,189,0.0006014411455140587,0.00039434188977912216,0.0004899393926825348
530,129,42,171,0.0007460183439549382,0.00019485128671438976,0.000443278498141341
531,139,46,185,0.00080384922333129,0.00021340855211576023,0.00047957030500671397
532,37,150,187,0.00021397425369250165,0.000695897452551392,0.0004847548488446244
533,165,14,179,0.0009542095097098047,6.495042890479659e-05,0.0004640166734929827
534,133,43,176,0.0007691506957054789,0.00019949060306473238,0.0004562398577361171
535,33,124,157,0.00019084190194196092,0.0005752752274424841,0.0004069866912759681
536,136,45,181,0.0007864999595183844,0.0002087692357654176,0.0004692012173308931
537,19,151,170,0.00010987867081506842,0.0007005367689017347,0.0004406862262223858
538,101,70,171,0.0005840918817011532,0.00032475214452398293,0.000443278498141341
539,37,127,164,0.00021397425369250165,0.0005891931764935119,0.00042513259470865455
540,131,38,169,0.0007575845198302086,0.00017629402131301932,0.0004380939543034306
541,163,30,193,0.0009426433338345343,0.0001391794905102784,0.0005003084803583557
542,28,134,162,0.00016192646225378504,0.0006216683909459102,0.00041994805087074415
543,168,16,184,0.0009715587735227102,7.422906160548182e-05,0.0004769780330877588
544,105,83,188,0.0006072242334516939,0.00038506325707843693,0.0004873471207635796
545,105,73,178,0.0006072242334516939,0.0003386700935750108,0.0004614244015740275
546,88,83,171,0.0005089117385118959,0.00038506325707843693,0.000443278498141341
547,43,131,174,0.00024867278131831275,0.0006077504418948823,0.00045105531389820665
548,98,59,157,0.0005667426178882476,0.00027371966467021417,0.0004069866912759681
549,93,78,171,0.0005378271782000717,0.00036186667532672387,0.000443278498141341
550,12,179,191,6.939705525162215e-05,0.0008304376267113279,0.0004951239365204453
551,69,118,187,0.0003990330676968274,0.0005474393293404283,0.0004847548488446244
552,126,1,127,0.0007286690801420326,4.639316350342614e-06,0.0003292185337073118
553,135,55,190,0.0007807168715807493,0.00025516239926884376,0.00049253166460149
554,68,114,182,0.0003932499797591922,0.000528882063939058,0.00047179348924984834
555,78,84,162,0.00045108085913554404,0.0003897025734287795,0.00041994805087074415
556,72,105,177,0.00041638233150973294,0.0004871282167859744,0.0004588321296550723
557,106,53,159,0.000613007321389329,0.0002458837665681585,0.00041217123511387853
558,68,91,159,0.0003932499797591922,0.0004221777878811778,0.00041217123511387853
559,139,23,162,0.00080384922333129,0.00010670427605788011,0.00041994805087074415
560,28,148,176,0.00016192646225378504,0.0006866188198507068,0.0004562398577361171
561,21,160,181,0.00012144484669033877,0.0007422906160548182,0.0004692012173308931
562,134,14,148,0.000774933783643114,6.495042890479659e-05,0.0003836562440053712
563,93,66,159,0.0005378271782000717,0.00030619487912261246,0.00041217123511387853
564,52,117,169,0.00030072057275702934,0.0005428000129900858,0.0004380939543034306
565,86,88,174,0.0004973455626366255,0.00040825983883015,0.00045105531389820665
566,102,56,158,0.0005898749696387883,0.00025980171561918635,0.0004095789631949233
567,50,117,167,0.000289154396881759,0.0005428000129900858,0.0004329094104655202
568,11,167,178,6.361396731398698e-05,0.0007747658305072165,0.0004614244015740275
569,47,111,158,0.0002718051330688534,0.0005149641148880301,0.0004095789631949233
570,37,133,170,0.00021397425369250165,0.0006170290745955676,0.0004406862262223858
571,18,152,170,0.00010409558287743323,0.0007051760852520773,0.0004406862262223858
572,152,16,168,0.0008790293665205473,7.422906160548182e-05,0.0004355016823844754
573,33,106,139,0.00019084190194196092,0.000491767533136317,0.0003603257967347743
574,34,117,151,0.0001966249898795961,0.0005428000129900858,0.00039143305976223683
575,107,57,164,0.0006187904093269642,0.000264441031969529,0.00042513259470865455
576,52,112,164,0.00030072057275702934,0.0005196034312383727,0.00042513259470865455
577,23,154,177,0.00013301102256560912,0.0007144547179527625,0.0004588321296550723
578,109,61,170,0.0006303565852022345,0.0002829982973708994,0.0004406862262223858
579,59,88,147,0.0003412021883204756,0.00040825983883015,0.000381063972086416
580,91,90,181,0.0005262610023248014,0.0004175384715308352,0.0004692012173308931
581,174,11,185,0.0010062573011485213,5.103247985376875e-05,0.00047957030500671397
582,71,98,169,0.00041059924357209776,0.0004546530023335761,0.0004380939543034306
583,85,79,164,0.0004915624746989903,0.00036650599167706646,0.00042513259470865455
584,41,142,183,0.00023710660544304236,0.0006587829217486512,0.00047438576116880357
585,106,57,163,0.000613007321389329,0.000264441031969529,0.0004225403227896993
586,42,134,176,0.00024288969338067754,0.0006216683909459102,0.0004562398577361171
587,68,73,141,0.0003932499797591922,0.0003386700935750108,0.00036551034057268473
588,24,134,158,0.0001387941105032443,0.0006216683909459102,0.0004095789631949233
589,5,149,154,2.89154396881759e-05,0.0006912581362010494,0.00039920987551910245
590,63,98,161,0.0003643345400710163,0.0004546530023335761,0.0004173557789517889
591,76,77,153,0.00043951468326027367,0.00035722735897638123,0.00039661760360014723
592,5,162,167,2.89154396881759e-05,0.0007515692487555034,0.0004329094104655202
593,75,77,152,0.0004337315953226385,0.00035722735897638123,0.00039402533168119206
594,64,82,146,0.0003701176280086515,0.0003804239407280943,0.00037847170016746076
595,28,113,141,0.00016192646225378504,0.0005242427475887153,0.00036551034057268473
596,57,108,165,0.00032963601244520525,0.0005010461658370022,0.0004277248666276098
597,68,93,161,0.0003932499797591922,0.00043145642058186305,0.0004173557789517889
598,2,160,162,1.1566175875270359e-05,0.0007422906160548182,0.00041994805087074415
599,71,85,156,0.00041059924357209776,0.00039434188977912216,0.00040439441935701285
600,136,43,179,0.0007864999595183844,0.00019949060306473238,0.0004640166734929827
601,4,140,144,2.3132351750540717e-05,0.0006495042890479659,0.00037328715632955036
602,1,133,134,5.783087937635179e-06,0.0006170290745955676,0.00034736443713999826
603,104,58,162,0.0006014411455140587,0.0002690803483198716,0.00041994805087074415
604,117,38,155,0.000676621288703316,0.00017629402131301932,0.0004018021474380577
605,6,145,151,3.4698527625811076e-05,0.0006727008707996789,0.00039143305976223683
606,61,89,150,0.000352768364195746,0.0004128991551804926,0.0003888407878432816
607,15,139,154,8.67463190645277e-05,0.0006448649726976233,0.00039920987551910245
608,53,101,154,0.0003065036606946645,0.000468570951384604,0.00039920987551910245
609,83,79,162,0.0004799962988237199,0.00036650599167706646,0.00041994805087074415
610,59,86,145,0.0003412021883204756,0.00039898120612946476,0.00037587942824850553
611,65,114,179,0.00037590071594628666,0.000528882063939058,0.0004640166734929827
612,4,126,130,2.3132351750540717e-05,0.0005845538601431693,0.0003369953494641774
613,38,125,163,0.00021975734163013684,0.0005799145437928267,0.0004225403227896993
614,72,86,158,0.00041638233150973294,0.00039898120612946476,0.0004095789631949233
615,75,66,141,0.0004337315953226385,0.00030619487912261246,0.00036551034057268473
616,57,89,146,0.00032963601244520525,0.0004128991551804926,0.00037847170016746076
617,84,85,169,0.0004857793867613551,0.00039434188977912216,0.0004380939543034306
618,78,98,176,0.00045108085913554404,0.0004546530023335761,0.0004562398577361171
619,68,91,159,0.0003932499797591922,0.0004221777878811778,0.00041217123511387853
620,92,59,151,0.0005320440902624365,0.00027371966467021417,0.00039143305976223683
621,43,92,135,0.00024867278131831275,0.00042681710423152046,0.00034995670905895343
622,120,35,155,0.0006939705525162216,0.00016237607226199147,0.0004018021474380577
623,46,102,148,0.00026602204513121824,0.0004732102677349466,0.0003836562440053712
624,48,116,164,0.0002775882210064886,0.0005381606966397432,0.00042513259470865455
625,68,66,134,0.0003932499797591922,0.00030619487912261246,0.00034736443713999826
626,2,201,203,1.1566175875270359e-05,0.0009325025864188653,0.0005262311995479078
627,155,11,166,0.0008963786303334528,5.103247985376875e-05,0.000430317138546565
628,108,46,154,0.0006245734972645994,0.00021340855211576023,0.00039920987551910245
629,94,51,145,0.0005436102661377069,0.0002366051338674733,0.00037587942824850553
630,81,78,159,0.00046843012294844953,0.00036186667532672387,0.00041217123511387853
631,99,50,149,0.0005725257058258828,0.00023196581751713067,0.0003862485159243264
632,9,135,144,5.204779143871662e-05,0.0006263077072962528,0.00037328715632955036
633,106,50,156,0.000613007321389329,0.00023196581751713067,0.00040439441935701285
634,72,82,154,0.00041638233150973294,0.0003804239407280943,0.00039920987551910245
635,121,18,139,0.0006997536404538567,8.350769430616704e-05,0.0003603257967347743
636,73,19,92,0.0004221654194473681,8.814701065650966e-05,0.0002384890165438794
637,122,21,143,0.000705536728391492,9.742564335719488e-05,0.00037069488441059513
638,149,8,157,0.0008616801027076417,3.711453080274091e-05,0.0004069866912759681
639,68,90,158,0.0003932499797591922,0.0004175384715308352,0.0004095789631949233
640,38,92,130,0.00021975734163013684,0.00042681710423152046,0.0003369953494641774
641,80,60,140,0.0004626470350108144,0.0002783589810205568,0.0003629180686537295
642,22,115,137,0.00012722793462797397,0.0005335213802894006,0.0003551412528968639
643,53,98,151,0.0003065036606946645,0.0004546530023335761,0.00039143305976223683
644,91,63,154,0.0005262610023248014,0.00029227693007158464,0.00039920987551910245
645,31,118,149,0.00017927572606669058,0.0005474393293404283,0.0003862485159243264
646,122,27,149,0.000705536728391492,0.00012526154145925056,0.0003862485159243264
647,26,124,150,0.00015036028637851467,0.0005752752274424841,0.0003888407878432816
648,35,114,149,0.0002024080778172313,0.000528882063939058,0.0003862485159243264
649,91,42,133,0.0005262610023248014,0.00019485128671438976,0.00034477216522104304
650,81,68,149,0.00046843012294844953,0.0003154735118232977,0.0003862485159243264
651,38,110,148,0.00021975734163013684,0.0005103247985376875,0.0003836562440053712
652,39,102,141,0.00022554042956777202,0.0004732102677349466,0.00036551034057268473
653,65,69,134,0.00037590071594628666,0.00032011282817364034,0.00034736443713999826
654,54,104,158,0.0003122867486322997,0.0004824889004356318,0.0004095789631949233
655,54,91,145,0.0003122867486322997,0.0004221777878811778,0.00037587942824850553
656,88,43,131,0.0005089117385118959,0.00019949060306473238,0.0003395876213831326
657,127,18,145,0.0007344521680796678,8.350769430616704e-05,0.00037587942824850553
658,75,61,136,0.0004337315953226385,0.0002829982973708994,0.00035254898097790866
659,35,103,138,0.0002024080778172313,0.00047784958408528917,0.00035773352481581906
660,105,43,148,0.0006072242334516939,0.00019949060306473238,0.0003836562440053712
661,1,172,173,5.783087937635179e-06,0.0007979624122589295,0.0004484630419792515
662,73,83,156,0.0004221654194473681,0.00038506325707843693,0.00040439441935701285
663,65,82,147,0.00037590071594628666,0.0003804239407280943,0.000381063972086416
664,55,87,142,0.0003180698365699349,0.0004036205224798074,0.0003681026124916399
665,34,125,159,0.0001966249898795961,0.0005799145437928267,0.00041217123511387853
666,110,11,121,0.0006361396731398698,5.103247985376875e-05,0.0003136649021935805
667,6,140,146,3.4698527625811076e-05,0.0006495042890479659,0.00037847170016746076
668,85,68,153,0.0004915624746989903,0.0003154735118232977,0.00039661760360014723
669,32,125,157,0.00018505881400432574,0.0005799145437928267,0.0004069866912759681
670,73,52,125,0.0004221654194473681,0.0002412444502178159,0.00032403398986940134
671,89,53,142,0.000514694826449531,0.0002458837665681585,0.0003681026124916399
672,25,121,146,0.0001445771984408795,0.0005613572783914562,0.00037847170016746076
673,77,92,169,0.00044529777119790885,0.00042681710423152046,0.0004380939543034306
674,24,118,142,0.0001387941105032443,0.0005474393293404283,0.0003681026124916399
675,51,92,143,0.00029493748481939416,0.00042681710423152046,0.00037069488441059513
676,79,67,146,0.0004568639470731792,0.0003108341954729551,0.00037847170016746076
677,89,42,131,0.000514694826449531,0.00019485128671438976,0.0003395876213831326
678,23,121,144,0.00013301102256560912,0.0005613572783914562,0.00037328715632955036
679,33,114,147,0.00019084190194196092,0.000528882063939058,0.000381063972086416
680,3,140,143,1.7349263812905538e-05,0.0006495042890479659,0.00037069488441059513
681,29,120,149,0.00016770955019142022,0.0005567179620411136,0.0003862485159243264
682,33,101,134,0.00019084190194196092,0.000468570951384604,0.00034736443713999826
683,179,3,182,0.0010351727408366971,1.391794905102784e-05,0.00047179348924984834
684,55,90,145,0.0003180698365699349,0.0004175384715308352,0.00037587942824850553
685,96,49,145,0.0005551764420129772,0.00022732650116678805,0.00037587942824850553
686,65,81,146,0.00037590071594628666,0.0003757846243777517,0.00037847170016746076
687,86,56,142,0.0004973455626366255,0.00025980171561918635,0.0003681026124916399
688,72,69,141,0.00041638233150973294,0.00032011282817364034,0.00036551034057268473
689,28,105,133,0.00016192646225378504,0.0004871282167859744,0.00034477216522104304
690,88,47,135,0.0005089117385118959,0.00021804786846610285,0.00034995670905895343
691,104,2,106,0.0006014411455140587,9.278632700685228e-06,0.0002747808234092523
692,94,60,154,0.0005436102661377069,0.0002783589810205568,0.00039920987551910245
693,76,69,145,0.00043951468326027367,0.00032011282817364034,0.00037587942824850553
694,22,127,149,0.00012722793462797397,0.0005891931764935119,0.0003862485159243264
695,58,106,164,0.00033541910038284044,0.000491767533136317,0.00042513259470865455
696,9,129,138,5.204779143871662e-05,0.0005984718091941972,0.00035773352481581906
697,112,44,156,0.0006477058490151401,0.000204129919415075,0.00040439441935701285
698,77,65,142,0.00044529777119790885,0.0003015555627722699,0.0003681026124916399
699,117,42,159,0.000676621288703316,0.00019485128671438976,0.00041217123511387853
700,100,6,106,0.000578308793763518,2.783589810205568e-05,0.0002747808234092523
701,74,63,137,0.0004279485073850033,0.00029227693007158464,0.0003551412528968639
702,68,64,132,0.0003932499797591922,0.0002969162464219273,0.0003421798933020878
703,50,82,132,0.000289154396881759,0.0003804239407280943,0.0003421798933020878
704,88,50,138,0.0005089117385118959,0.00023196581751713067,0.00035773352481581906
705,145,3,148,0.000838547750957101,1.391794905102784e-05,0.0003836562440053712
706,88,41,129,0.0005089117385118959,0.00019021197036404714,0.0003344030775452222
707,98,45,143,0.0005667426178882476,0.0002087692357654176,0.00037069488441059513
708,32,106,138,0.00018505881400432574,0.000491767533136317,0.00035773352481581906
709,21,139,160,0.00012144484669033877,0.0006448649726976233,0.0004147635070328337
710,124,26,150,0.0007171029042667623,0.00012062222510890795,0.0003888407878432816
711,7,142,149,4.048161556344626e-05,0.0006587829217486512,0.0003862485159243264
712,63,88,151,0.0003643345400710163,0.00040825983883015,0.00039143305976223683
713,69,64,133,0.0003990330676968274,0.0002969162464219273,0.00034477216522104304
714,81,74,155,0.00046843012294844953,0.0003433094099253534,0.0004018021474380577
715,41,98,139,0.00023710660544304236,0.0004546530023335761,0.0003603257967347743
716,50,96,146,0.000289154396881759,0.0004453743696328909,0.00037847170016746076
717,27,114,141,0.00015614337431614985,0.000528882063939058,0.00036551034057268473
718,5,126,131,2.89154396881759e-05,0.0005845538601431693,0.0003395876213831326
719,32,96,128,0.00018505881400432574,0.0004453743696328909,0.00033181080562626696
720,17,133,150,9.831249493979805e-05,0.0006170290745955676,0.0003888407878432816
721,66,52,118,0.00038168380388392184,0.0002412444502178159,0.00030588808643671486
722,30,100,130,0.0001734926381290554,0.00046393163503426134,0.0003369953494641774
723,89,51,140,0.000514694826449531,0.0002366051338674733,0.0003629180686537295
724,32,105,137,0.00018505881400432574,0.0004871282167859744,0.0003551412528968639
725,43,89,132,0.00024867278131831275,0.0004128991551804926,0.0003421798933020878
726,15,116,131,8.67463190645277e-05,0.0005381606966397432,0.0003395876213831326
727,68,48,116,0.0003932499797591922,0.00022268718481644544,0.00030070354259880447
728,75,57,132,0.0004337315953226385,0.000264441031969529,0.0003421798933020878
729,23,68,91,0.00013301102256560912,0.0003154735118232977,0.00023589674462492417
730,68,65,133,0.0003932499797591922,0.0003015555627722699,0.00034477216522104304
731,102,33,135,0.0005898749696387883,0.00015309743956130623,0.00034995670905895343
732,33,75,108,0.00019084190194196092,0.000347948726275696,0.00027996536724716277
733,73,62,135,0.0004221654194473681,0.00028763761372124205,0.00034995670905895343
734,66,76,142,0.00038168380388392184,0.00035258804262603864,0.0003681026124916399
735,103,31,134,0.0005956580575764235,0.00014381880686062103,0.00034736443713999826
736,48,72,120,0.0002775882210064886,0.00033403077722466817,0.00031107263027462526
737,93,53,146,0.0005378271782000717,0.0002458837665681585,0.00037847170016746076
738,40,88,128,0.0002313235175054072,0.00040825983883015,0.00033181080562626696
739,59,84,143,0.0003412021883204756,0.0003897025734287795,0.00037069488441059513
740,89,42,131,0.000514694826449531,0.00019485128671438976,0.0003395876213831326
741,32,112,144,0.00018505881400432574,0.0005196034312383727,0.00037328715632955036
742,79,52,131,0.0004568639470731792,0.0002412444502178159,0.0003395876213831326
743,40,82,122,0.0002313235175054072,0.0003804239407280943,0.0003162571741125357
744,66,68,134,0.00038168380388392184,0.0003154735118232977,0.00034736443713999826
745,61,53,114,0.000352768364195746,0.0002458837665681585,0.000295518998760894
746,66,65,131,0.00038168380388392184,0.0003015555627722699,0.0003395876213831326
747,45,90,135,0.00026023895719358306,0.0004175384715308352,0.00034995670905895343
748,15,120,135,8.67463190645277e-05,0.0005567179620411136,0.00034995670905895343
749,50,70,120,0.000289154396881759,0.00032475214452398293,0.00031107263027462526
750,132,13,145,0.0007633676077678437,6.0311112554453976e-05,0.00037587942824850553
751,90,26,116,0.0005204779143871661,0.00012062222510890795,0.00030070354259880447
752,28,108,136,0.00016192646225378504,0.0005010461658370022,0.00035254898097790866
753,44,94,138,0.00025445586925594793,0.0004360957369322057,0.00035773352481581906
754,70,57,127,0.0004048161556344626,0.000264441031969529,0.0003292185337073118
755,76,69,145,0.00043951468326027367,0.00032011282817364034,0.00037587942824850553
756,82,43,125,0.0004742132108860847,0.00019949060306473238,0.00032403398986940134
757,31,99,130,0.00017927572606669058,0.00045929231868391875,0.0003369953494641774
758,51,84,135,0.00029493748481939416,0.0003897025734287795,0.00034995670905895343
759,20,112,132,0.0001156617587527036,0.0005196034312383727,0.0003421798933020878
760,22,108,130,0.00012722793462797397,0.0005010461658370022,0.0003369953494641774
761,45,84,129,0.00026023895719358306,0.0003897025734287795,0.0003344030775452222
762,25,94,119,0.0001445771984408795,0.0004360957369322057,0.0003084803583556701
763,1,148,149,5.783087937635179e-06,0.0006866188198507068,0.0003862485159243264
764,10,124,134,5.78308793763518e-05,0.0005752752274424841,0.00034736443713999826
765,43,94,137,0.00024867278131831275,0.0004360957369322057,0.0003551412528968639
766,95,50,145,0.0005493933540753421,0.00023196581751713067,0.00037587942824850553
767,32,86,118,0.00018505881400432574,0.00039898120612946476,0.00030588808643671486
768,5,133,138,2.89154396881759e-05,0.0006170290745955676,0.00035773352481581906
769,71,50,121,0.00041059924357209776,0.00023196581751713067,0.0003136649021935805
770,99,32,131,0.0005725257058258828,0.00014845812321096364,0.0003395876213831326
771,46,82,128,0.00026602204513121824,0.0003804239407280943,0.00033181080562626696
772,101,46,147,0.0005840918817011532,0.00021340855211576023,0.000381063972086416
773,88,42,130,0.0005089117385118959,0.00019485128671438976,0.0003369953494641774
774,36,80,116,0.00020819116575486647,0.0003711453080274091,0.00030070354259880447
775,12,114,126,6.939705525162215e-05,0.000528882063939058,0.00032662626178835656
776,47,78,125,0.0002718051330688534,0.00036186667532672387,0.00032403398986940134
777,17,104,121,9.831249493979805e-05,0.0004824889004356318,0.0003136649021935805
778,53,72,125,0.0003065036606946645,0.00033403077722466817,0.00032403398986940134
779,23,122,145,0.00013301102256560912,0.0005659965947417988,0.00037587942824850553
780,46,76,122,0.00026602204513121824,0.00035258804262603864,0.0003162571741125357
781,23,92,115,0.00013301102256560912,0.00042681710423152046,0.00029811127067984924
782,16,117,133,9.252940700216287e-05,0.0005428000129900858,0.00034477216522104304
783,51,73,124,0.00029493748481939416,0.0003386700935750108,0.0003214417179504461
784,29,90,119,0.00016770955019142022,0.0004175384715308352,0.0003084803583556701
785,56,77,133,0.00032385292450757007,0.00035722735897638123,0.00034477216522104304
786,33,87,120,0.00019084190194196092,0.0004036205224798074,0.00031107263027462526
787,47,87,134,0.0002718051330688534,0.0004036205224798074,0.00034736443713999826
788,1,3,4,5.783087937635179e-06,1.391794905102784e-05,1.0369087675820843e-05
789,160,1,161,0.0009252940700216288,4.639316350342614e-06,0.0004173557789517889
790,98,31,129,0.0005667426178882476,0.00014381880686062103,0.0003344030775452222
791,83,43,126,0.0004799962988237199,0.00019949060306473238,0.00032662626178835656
792,22,106,128,0.00012722793462797397,0.000491767533136317,0.00033181080562626696
793,94,44,138,0.0005436102661377069,0.000204129919415075,0.00035773352481581906
794,24,82,106,0.0001387941105032443,0.0003804239407280943,0.0002747808234092523
795,35,84,119,0.0002024080778172313,0.0003897025734287795,0.0003084803583556701
796,40,70,110,0.0002313235175054072,0.00032475214452398293,0.00028514991108507317
797,130,5,135,0.0007518014318925733,2.319658175171307e-05,0.00034995670905895343
798,65,71,136,0.00037590071594628666,0.0003293914608743256,0.00035254898097790866
799,1,95,96,5.783087937635179e-06,0.0004407350532825483,0.0002488581042197002
800,5,150,155,2.89154396881759e-05,0.000695897452551392,0.0004018021474380577
801,1,129,130,5.783087937635179e-06,0.0005984718091941972,0.0003369953494641774
802,53,60,113,0.0003065036606946645,0.0002783589810205568,0.0002929267268419388
803,85,24,109,0.0004915624746989903,0.00011134359240822272,0.000282557639166118
804,28,93,121,0.00016192646225378504,0.00043145642058186305,0.0003136649021935805
805,3,127,130,1.7349263812905538e-05,0.0005891931764935119,0.0003369953494641774
806,25,96,121,0.0001445771984408795,0.0004453743696328909,0.0003136649021935805
807,71,29,100,0.00041059924357209776,0.0001345401741599358,0.00025922719189552107
808,110,23,133,0.0006361396731398698,0.00010670427605788011,0.00034477216522104304
809,80,18,98,0.0004626470350108144,8.350769430616704e-05,0.00025404264805761067
810,114,34,148,0.0006592720248904105,0.00015773675591164885,0.0003836562440053712
811,62,40,102,0.00035855145213338117,0.00018557265401370455,0.00026441173573343147
812,21,86,107,0.00012144484669033877,0.00039898120612946476,0.00027737309532820754
813,51,40,91,0.00029493748481939416,0.00018557265401370455,0.00023589674462492417
814,12,116,128,6.939705525162215e-05,0.0005381606966397432,0.00033181080562626696
815,13,114,127,7.518014318925733e-05,0.000528882063939058,0.0003292185337073118
816,79,64,143,0.0004568639470731792,0.0002969162464219273,0.00037069488441059513
817,53,67,120,0.0003065036606946645,0.0003108341954729551,0.00031107263027462526
818,3,104,107,1.7349263812905538e-05,0.0004824889004356318,0.00027737309532820754
819,40,84,124,0.0002313235175054072,0.0003897025734287795,0.0003214417179504461
820,1,115,116,5.783087937635179e-06,0.0005335213802894006,0.00030070354259880447
821,175,1,176,0.0010120403890861564,4.639316350342614e-06,0.0004562398577361171
822,155,1,156,0.0008963786303334528,4.639316350342614e-06,0.00040439441935701285
823,19,107,126,0.00010987867081506842,0.0004964068494866596,0.00032662626178835656
824,52,77,129,0.00030072057275702934,0.00035722735897638123,0.0003344030775452222
825,10,112,122,5.78308793763518e-05,0.0005196034312383727,0.0003162571741125357
826,33,94,127,0.00019084190194196092,0.0004360957369322057,0.0003292185337073118
827,8,99,107,4.6264703501081435e-05,0.00045929231868391875,0.00027737309532820754
828,47,77,124,0.0002718051330688534,0.00035722735897638123,0.0003214417179504461
829,115,4,119,0.0006650551128280456,1.8557265401370455e-05,0.0003084803583556701
830,69,49,118,0.0003990330676968274,0.00022732650116678805,0.00030588808643671486
831,22,95,117,0.00012722793462797397,0.0004407350532825483,0.00030329581451775964
832,115,15,130,0.0006650551128280456,6.95897452551392e-05,0.0003369953494641774
833,54,66,120,0.0003122867486322997,0.00030619487912261246,0.00031107263027462526
834,13,98,111,7.518014318925733e-05,0.0004546530023335761,0.0002877421830040284
835,39,81,120,0.00022554042956777202,0.0003757846243777517,0.00031107263027462526
836,40,69,109,0.0002313235175054072,0.00032011282817364034,0.000282557639166118
837,54,57,111,0.0003122867486322997,0.000264441031969529,0.0002877421830040284
838,44,75,119,0.00025445586925594793,0.000347948726275696,0.0003084803583556701
839,66,44,110,0.00038168380388392184,0.000204129919415075,0.00028514991108507317
840,89,27,116,0.000514694826449531,0.00012526154145925056,0.00030070354259880447
841,36,93,129,0.00020819116575486647,0.00043145642058186305,0.0003344030775452222
842,12,123,135,6.939705525162215e-05,0.0005706359110921415,0.00034995670905895343
843,72,55,127,0.00041638233150973294,0.00025516239926884376,0.0003292185337073118
844,108,20,128,0.0006245734972645994,9.278632700685228e-05,0.00033181080562626696
845,81,44,125,0.00046843012294844953,0.000204129919415075,0.00032403398986940134
846,39,84,123,0.00022554042956777202,0.0003897025734287795,0.00031884944603149094
847,46,87,133,0.00026602204513121824,0.0004036205224798074,0.00034477216522104304
848,10,124,134,5.78308793763518e-05,0.0005752752274424841,0.00034736443713999826
849,53,69,122,0.0003065036606946645,0.00032011282817364034,0.0003162571741125357
850,18,104,122,0.00010409558287743323,0.0004824889004356318,0.0003162571741125357
851,32,86,118,0.00018505881400432574,0.00039898120612946476,0.00030588808643671486
852,43,74,117,0.00024867278131831275,0.0003433094099253534,0.00030329581451775964
853,77,56,133,0.00044529777119790885,0.00025980171561918635,0.00034477216522104304
854,34,86,120,0.0001966249898795961,0.00039898120612946476,0.00031107263027462526
855,58,65,123,0.00033541910038284044,0.0003015555627722699,0.00031884944603149094
856,1,115,116,5.783087937635179e-06,0.0005335213802894006,0.00030070354259880447
857,69,55,124,0.0003990330676968274,0.00025516239926884376,0.0003214417179504461
858,24,94,118,0.0001387941105032443,0.0004360957369322057,0.00030588808643671486
859,72,51,123,0.00041638233150973294,0.0002366051338674733,0.00031884944603149094
860,67,50,117,0.000387466891821557,0.00023196581751713067,0.00030329581451775964
861,37,83,120,0.00021397425369250165,0.00038506325707843693,0.00031107263027462526
862,9,113,122,5.204779143871662e-05,0.0005242427475887153,0.0003162571741125357
863,59,48,107,0.0003412021883204756,0.00022268718481644544,0.00027737309532820754
864,145,3,148,0.000838547750957101,1.391794905102784e-05,0.0003836562440053712
865,70,43,113,0.0004048161556344626,0.00019949060306473238,0.0002929267268419388
866,116,8,124,0.0006708382007656809,3.711453080274091e-05,0.0003214417179504461
867,1,33,34,5.783087937635179e-06,0.00015309743956130623,8.813724524447716e-05
868,40,74,114,0.0002313235175054072,0.0003433094099253534,0.000295518998760894
869,31,83,114,0.00017927572606669058,0.00038506325707843693,0.000295518998760894
870,105,29,134,0.0006072242334516939,0.0001345401741599358,0.00034736443713999826
871,27,90,117,0.00015614337431614985,0.0004175384715308352,0.00030329581451775964
872,56,52,108,0.00032385292450757007,0.0002412444502178159,0.00027996536724716277
873,60,50,110,0.0003469852762581108,0.00023196581751713067,0.00028514991108507317
874,10,102,112,5.78308793763518e-05,0.0004732102677349466,0.0002903344549229836
875,13,94,107,7.518014318925733e-05,0.0004360957369322057,0.00027737309532820754
876,55,54,109,0.0003180698365699349,0.0002505230829185011,0.000282557639166118
877,93,33,126,0.0005378271782000717,0.00015309743956130623,0.00032662626178835656
878,99,12,111,0.0005725257058258828,5.567179620411136e-05,0.0002877421830040284
879,71,41,112,0.00041059924357209776,0.00019021197036404714,0.0002903344549229836
880,84,48,132,0.0004857793867613551,0.00022268718481644544,0.0003421798933020878
881,29,93,122,0.00016770955019142022,0.00043145642058186305,0.0003162571741125357
882,13,95,108,7.518014318925733e-05,0.0004407350532825483,0.00027996536724716277
883,30,88,118,0.0001734926381290554,0.00040825983883015,0.00030588808643671486
884,57,53,110,0.00032963601244520525,0.0002458837665681585,0.00028514991108507317
885,38,66,104,0.00021975734163013684,0.00030619487912261246,0.0002695962795713419
886,53,61,114,0.0003065036606946645,0.0002829982973708994,0.000295518998760894
887,36,83,119,0.00020819116575486647,0.00038506325707843693,0.0003084803583556701
888,24,89,113,0.0001387941105032443,0.0004128991551804926,0.0002929267268419388
889,119,9,128,0.0006881874645785864,4.175384715308352e-05,0.00033181080562626696
890,110,1,111,0.0006361396731398698,4.639316350342614e-06,0.0002877421830040284
891,55,62,117,0.0003180698365699349,0.00028763761372124205,0.00030329581451775964
892,42,73,115,0.00024288969338067754,0.0003386700935750108,0.00029811127067984924
893,45,85,130,0.00026023895719358306,0.00039434188977912216,0.0003369953494641774
894,40,66,106,0.0002313235175054072,0.00030619487912261246,0.0002747808234092523
895,107,11,118,0.0006187904093269642,5.103247985376875e-05,0.00030588808643671486
896,19,100,119,0.00010987867081506842,0.00046393163503426134,0.0003084803583556701
897,46,83,129,0.00026602204513121824,0.00038506325707843693,0.0003344030775452222
898,1,91,92,5.783087937635179e-06,0.0004221777878811778,0.0002384890165438794
899,55,28,83,0.0003180698365699349,0.00012990085780959317,0.0002151585692732825
900,4,108,112,2.3132351750540717e-05,0.0005010461658370022,0.0002903344549229836
901,63,52,115,0.0003643345400710163,0.0002412444502178159,0.00029811127067984924
902,54,56,110,0.0003122867486322997,0.00025980171561918635,0.00028514991108507317
903,84,33,117,0.0004857793867613551,0.00015309743956130623,0.00030329581451775964
904,43,73,116,0.00024867278131831275,0.0003386700935750108,0.00030070354259880447
905,56,89,145,0.00032385292450757007,0.0004128991551804926,0.00037587942824850553
906,1,130,131,5.783087937635179e-06,0.0006031111255445397,0.0003395876213831326
907,48,67,115,0.0002775882210064886,0.0003108341954729551,0.00029811127067984924
908,24,76,100,0.0001387941105032443,0.00035258804262603864,0.00025922719189552107
909,63,44,107,0.0003643345400710163,0.000204129919415075,0.00027737309532820754
910,55,56,111,0.0003180698365699349,0.00025980171561918635,0.0002877421830040284
911,138,9,147,0.0007980661353936548,4.175384715308352e-05,0.000381063972086416
912,65,61,126,0.00037590071594628666,0.0002829982973708994,0.00032662626178835656
913,40,78,118,0.0002313235175054072,0.00036186667532672387,0.00030588808643671486
914,35,64,99,0.0002024080778172313,0.0002969162464219273,0.00025663491997656584
915,50,75,125,0.000289154396881759,0.000347948726275696,0.00032403398986940134
916,35,78,113,0.0002024080778172313,0.00036186667532672387,0.0002929267268419388
917,12,100,112,6.939705525162215e-05,0.00046393163503426134,0.0002903344549229836
918,29,87,116,0.00016770955019142022,0.0004036205224798074,0.00030070354259880447
919,24,121,145,0.0001387941105032443,0.0005613572783914562,0.00037587942824850553
920,21,90,111,0.00012144484669033877,0.0004175384715308352,0.0002877421830040284
921,4,107,111,2.3132351750540717e-05,0.0004964068494866596,0.0002877421830040284
922,87,18,105,0.0005031286505742606,8.350769430616704e-05,0.00027218855149029714
923,68,48,116,0.0003932499797591922,0.00022268718481644544,0.00030070354259880447
924,54,48,102,0.0003122867486322997,0.00022268718481644544,0.00026441173573343147
925,67,40,107,0.000387466891821557,0.00018557265401370455,0.00027737309532820754
926,61,52,113,0.000352768364195746,0.0002412444502178159,0.0002929267268419388
927,16,94,110,9.252940700216287e-05,0.0004360957369322057,0.00028514991108507317
928,2,111,113,1.1566175875270359e-05,0.0005149641148880301,0.0002929267268419388
929,11,113,124,6.361396731398698e-05,0.0005242427475887153,0.0003214417179504461
930,25,89,114,0.0001445771984408795,0.0004128991551804926,0.000295518998760894
931,63,42,105,0.0003643345400710163,0.00019485128671438976,0.00027218855149029714
932,5,90,95,2.89154396881759e-05,0.0004175384715308352,0.000246265832300745
933,1,118,119,5.783087937635179e-06,0.0005474393293404283,0.0003084803583556701
934,41,53,94,0.00023710660544304236,0.0002458837665681585,0.0002436735603817898
935,55,61,116,0.0003180698365699349,0.0002829982973708994,0.00030070354259880447
936,30,70,100,0.0001734926381290554,0.00032475214452398293,0.00025922719189552107
937,16,97,113,9.252940700216287e-05,0.0004500136859832335,0.0002929267268419388
938,1,98,99,5.783087937635179e-06,0.0004546530023335761,0.00025663491997656584
939,85,34,119,0.0004915624746989903,0.00015773675591164885,0.0003084803583556701
940,9,110,119,5.204779143871662e-05,0.0005103247985376875,0.0003084803583556701
941,93,25,118,0.0005378271782000717,0.00011598290875856534,0.00030588808643671486
942,27,76,103,0.00015614337431614985,0.00035258804262603864,0.0002670040076523867
943,44,61,105,0.00025445586925594793,0.0002829982973708994,0.00027218855149029714
944,1,87,88,5.783087937635179e-06,0.0004036205224798074,0.00022811992886805855
945,27,81,108,0.00015614337431614985,0.0003757846243777517,0.00027996536724716277
946,14,70,84,8.096323112689252e-05,0.00032475214452398293,0.0002177508411922377
947,124,7,131,0.0007171029042667623,3.247521445239829e-05,0.0003395876213831326
948,50,52,102,0.000289154396881759,0.0002412444502178159,0.00026441173573343147
949,64,22,86,0.0003701176280086515,0.0001020649597075375,0.00022293538503014812
950,80,28,108,0.0004626470350108144,0.00012990085780959317,0.00027996536724716277
951,82,19,101,0.0004742132108860847,8.814701065650966e-05,0.0002618194638144763
952,86,25,111,0.0004973455626366255,0.00011598290875856534,0.0002877421830040284
953,89,24,113,0.000514694826449531,0.00011134359240822272,0.0002929267268419388
954,81,24,105,0.00046843012294844953,0.00011134359240822272,0.00027218855149029714
955,62,48,110,0.00035855145213338117,0.00022268718481644544,0.00028514991108507317
956,54,40,94,0.0003122867486322997,0.00018557265401370455,0.0002436735603817898
957,31,55,86,0.00017927572606669058,0.00025516239926884376,0.00022293538503014812
958,44,65,109,0.00025445586925594793,0.0003015555627722699,0.000282557639166118
959,65,33,98,0.00037590071594628666,0.00015309743956130623,0.00025404264805761067
960,17,79,96,9.831249493979805e-05,0.00036650599167706646,0.0002488581042197002
961,75,25,100,0.0004337315953226385,0.00011598290875856534,0.00025922719189552107
962,49,56,105,0.0002833713089441238,0.00025980171561918635,0.00027218855149029714
963,58,49,107,0.00033541910038284044,0.00022732650116678805,0.00027737309532820754
964,33,59,92,0.00019084190194196092,0.00027371966467021417,0.0002384890165438794
965,32,88,120,0.00018505881400432574,0.00040825983883015,0.00031107263027462526
966,40,57,97,0.0002313235175054072,0.000264441031969529,0.00025145037613865545
967,13,89,102,7.518014318925733e-05,0.0004128991551804926,0.00026441173573343147
968,85,21,106,0.0004915624746989903,9.742564335719488e-05,0.0002747808234092523
969,42,66,108,0.00024288969338067754,0.00030619487912261246,0.00027996536724716277
970,44,55,99,0.00025445586925594793,0.00025516239926884376,0.00025663491997656584
971,38,72,110,0.00021975734163013684,0.00033403077722466817,0.00028514991108507317
972,55,46,101,0.0003180698365699349,0.00021340855211576023,0.0002618194638144763
973,24,70,94,0.0001387941105032443,0.00032475214452398293,0.0002436735603817898
974,53,61,114,0.0003065036606946645,0.0002829982973708994,0.000295518998760894
975,11,91,102,6.361396731398698e-05,0.0004221777878811778,0.00026441173573343147
976,56,40,96,0.00032385292450757007,0.00018557265401370455,0.0002488581042197002
977,17,59,76,9.831249493979805e-05,0.00027371966467021417,0.00019701266584059603
978,34,82,116,0.0001966249898795961,0.0003804239407280943,0.00030070354259880447
979,42,69,111,0.00024288969338067754,0.00032011282817364034,0.0002877421830040284
980,130,1,131,0.0007518014318925733,4.639316350342614e-06,0.0003395876213831326
981,2,94,96,1.1566175875270359e-05,0.0004360957369322057,0.0002488581042197002
982,52,44,96,0.00030072057275702934,0.000204129919415075,0.0002488581042197002
983,31,70,101,0.00017927572606669058,0.00032475214452398293,0.0002618194638144763
984,42,75,117,0.00024288969338067754,0.000347948726275696,0.00030329581451775964
985,42,79,121,0.00024288969338067754,0.00036650599167706646,0.0003136649021935805
986,59,23,82,0.0003412021883204756,0.00010670427605788011,0.00021256629735432727
987,46,55,101,0.00026602204513121824,0.00025516239926884376,0.0002618194638144763
988,41,62,103,0.00023710660544304236,0.00028763761372124205,0.0002670040076523867
989,55,32,87,0.0003180698365699349,0.00014845812321096364,0.00022552765694910332
990,50,50,100,0.000289154396881759,0.00023196581751713067,0.00025922719189552107
991,33,53,86,0.00019084190194196092,0.0002458837665681585,0.00022293538503014812
992,4,104,108,2.3132351750540717e-05,0.0004824889004356318,0.00027996536724716277
993,51,53,104,0.00029493748481939416,0.0002458837665681585,0.0002695962795713419
994,24,86,110,0.0001387941105032443,0.00039898120612946476,0.00028514991108507317
995,34,73,107,0.0001966249898795961,0.0003386700935750108,0.00027737309532820754
996,38,56,94,0.00021975734163013684,0.00025980171561918635,0.0002436735603817898
997,87,6,93,0.0005031286505742606,2.783589810205568e-05,0.0002410812884628346
998,23,67,90,0.00013301102256560912,0.0003108341954729551,0.00023330447270596897
999,4,98,102,2.3132351750540717e-05,0.0004546530023335761,0.00026441173573343147
1000,28,76,104,0.00016192646225378504,0.00035258804262603864,0.0002695962795713419
1001,56,47,103,0.00032385292450757007,0.00021804786846610285,0.0002670040076523867
1002,45,60,105,0.00026023895719358306,0.0002783589810205568,0.00027218855149029714
1003,51,50,101,0.00029493748481939416,0.00023196581751713067,0.0002618194638144763
1004,92,3,95,0.0005320440902624365,1.391794905102784e-05,0.000246265832300745
1005,27,90,117,0.00015614337431614985,0.0004175384715308352,0.00030329581451775964
1006,31,73,104,0.00017927572606669058,0.0003386700935750108,0.0002695962795713419
1007,15,76,91,8.67463190645277e-05,0.00035258804262603864,0.00023589674462492417
1008,14,87,101,8.096323112689252e-05,0.0004036205224798074,0.0002618194638144763
1009,76,23,99,0.00043951468326027367,0.00010670427605788011,0.00025663491997656584
1010,40,70,110,0.0002313235175054072,0.00032475214452398293,0.00028514991108507317
1011,29,82,111,0.00016770955019142022,0.0003804239407280943,0.0002877421830040284
1012,28,73,101,0.00016192646225378504,0.0003386700935750108,0.0002618194638144763
1013,16,86,102,9.252940700216287e-05,0.00039898120612946476,0.00026441173573343147
1014,1,100,101,5.783087937635179e-06,0.00046393163503426134,0.0002618194638144763
1015,40,74,114,0.0002313235175054072,0.0003433094099253534,0.000295518998760894
1016,111,4,115,0.0006419227610775049,1.8557265401370455e-05,0.00029811127067984924
1017,24,76,100,0.0001387941105032443,0.00035258804262603864,0.00025922719189552107
1018,41,73,114,0.00023710660544304236,0.0003386700935750108,0.000295518998760894
1019,8,88,96,4.6264703501081435e-05,0.00040825983883015,0.0002488581042197002
1020,3,12,15,1.7349263812905538e-05,5.567179620411136e-05,3.888407878432816e-05
1021,6,64,70,3.4698527625811076e-05,0.0002969162464219273,0.00018145903432686475
1022,56,40,96,0.00032385292450757007,0.00018557265401370455,0.0002488581042197002
1023,28,63,91,0.00016192646225378504,0.00029227693007158464,0.00023589674462492417
1024,22,77,99,0.00012722793462797397,0.00035722735897638123,0.00025663491997656584
1025,23,70,93,0.00013301102256560912,0.00032475214452398293,0.0002410812884628346
1026,75,34,109,0.0004337315953226385,0.00015773675591164885,0.000282557639166118
1027,27,75,102,0.00015614337431614985,0.000347948726275696,0.00026441173573343147
1028,34,53,87,0.0001966249898795961,0.0002458837665681585,0.00022552765694910332
1029,84,19,103,0.0004857793867613551,8.814701065650966e-05,0.0002670040076523867
1030,60,27,87,0.0003469852762581108,0.00012526154145925056,0.00022552765694910332
1031,54,64,118,0.0003122867486322997,0.0002969162464219273,0.00030588808643671486
1032,17,58,75,9.831249493979805e-05,0.0002690803483198716,0.0001944203939216408
1033,35,69,104,0.0002024080778172313,0.00032011282817364034,0.0002695962795713419
1034,69,39,108,0.0003990330676968274,0.00018093333766336194,0.00027996536724716277
1035,29,76,105,0.00016770955019142022,0.00035258804262603864,0.00027218855149029714
1036,27,79,106,0.00015614337431614985,0.00036650599167706646,0.0002747808234092523
1037,48,46,94,0.0002775882210064886,0.00021340855211576023,0.0002436735603817898
1038,43,55,98,0.00024867278131831275,0.00025516239926884376,0.00025404264805761067
1039,28,72,100,0.00016192646225378504,0.00033403077722466817,0.00025922719189552107
1040,75,34,109,0.0004337315953226385,0.00015773675591164885,0.000282557639166118
1041,24,72,96,0.0001387941105032443,0.00033403077722466817,0.0002488581042197002
1042,77,19,96,0.00044529777119790885,8.814701065650966e-05,0.0002488581042197002
1043,54,39,93,0.0003122867486322997,0.00018093333766336194,0.0002410812884628346
1044,14,87,101,8.096323112689252e-05,0.0004036205224798074,0.0002618194638144763
1045,70,1,71,0.0004048161556344626,4.639316350342614e-06,0.00018405130624581995
1046,1,101,102,5.783087937635179e-06,0.000468570951384604,0.00026441173573343147
1047,5,93,98,2.89154396881759e-05,0.00043145642058186305,0.00025404264805761067
1048,32,56,88,0.00018505881400432574,0.00025980171561918635,0.00022811992886805855
1049,65,30,95,0.00037590071594628666,0.0001391794905102784,0.000246265832300745
1050,49,61,110,0.0002833713089441238,0.0002829982973708994,0.00028514991108507317
1051,58,43,101,0.00033541910038284044,0.00019949060306473238,0.0002618194638144763
1052,60,35,95,0.0003469852762581108,0.00016237607226199147,0.000246265832300745
1053,30,59,89,0.0001734926381290554,0.00027371966467021417,0.00023071220078701375
1054,77,22,99,0.00044529777119790885,0.0001020649597075375,0.00025663491997656584
1055,31,73,104,0.00017927572606669058,0.0003386700935750108,0.0002695962795713419
1056,45,60,105,0.00026023895719358306,0.0002783589810205568,0.00027218855149029714
1057,21,76,97,0.00012144484669033877,0.00035258804262603864,0.00025145037613865545
1058,67,30,97,0.000387466891821557,0.0001391794905102784,0.00025145037613865545
1059,89,12,101,0.000514694826449531,5.567179620411136e-05,0.0002618194638144763
1060,35,49,84,0.0002024080778172313,0.00022732650116678805,0.0002177508411922377
1061,83,20,103,0.0004799962988237199,9.278632700685228e-05,0.0002670040076523867
1062,35,64,99,0.0002024080778172313,0.0002969162464219273,0.00025663491997656584
1063,48,44,92,0.0002775882210064886,0.000204129919415075,0.0002384890165438794
1064,80,28,108,0.0004626470350108144,0.00012990085780959317,0.00027996536724716277
1065,60,36,96,0.0003469852762581108,0.00016701538861233408,0.0002488581042197002
1066,1,100,101,5.783087937635179e-06,0.00046393163503426134,0.0002618194638144763
1067,52,42,94,0.00030072057275702934,0.00019485128671438976,0.0002436735603817898
1068,26,72,98,0.00015036028637851467,0.00033403077722466817,0.00025404264805761067
1069,19,80,99,0.00010987867081506842,0.0003711453080274091,0.00025663491997656584
1070,19,80,99,0.00010987867081506842,0.0003711453080274091,0.00025663491997656584
1071,90,14,104,0.0005204779143871661,6.495042890479659e-05,0.0002695962795713419
1072,45,41,86,0.00026023895719358306,0.00019021197036404714,0.00022293538503014812
1073,25,59,84,0.0001445771984408795,0.00027371966467021417,0.0002177508411922377
1074,109,10,119,0.0006303565852022345,4.639316350342614e-05,0.0003084803583556701
1075,61,36,97,0.000352768364195746,0.00016701538861233408,0.00025145037613865545
1076,25,64,89,0.0001445771984408795,0.0002969162464219273,0.00023071220078701375
1077,122,2,124,0.000705536728391492,9.278632700685228e-06,0.0003214417179504461
1078,58,50,108,0.00033541910038284044,0.00023196581751713067,0.00027996536724716277
1079,2,120,122,1.1566175875270359e-05,0.0005567179620411136,0.0003162571741125357
1080,8,92,100,4.6264703501081435e-05,0.00042681710423152046,0.00025922719189552107
1081,42,26,68,0.00024288969338067754,0.00012062222510890795,0.00017627449048895433
1082,27,56,83,0.00015614337431614985,0.00025980171561918635,0.0002151585692732825
1083,6,80,86,3.4698527625811076e-05,0.0003711453080274091,0.00022293538503014812
1084,61,10,71,0.000352768364195746,4.639316350342614e-05,0.00018405130624581995
1085,5,91,96,2.89154396881759e-05,0.0004221777878811778,0.0002488581042197002
1086,3,85,88,1.7349263812905538e-05,0.00039434188977912216,0.00022811992886805855
1087,41,51,92,0.00023710660544304236,0.0002366051338674733,0.0002384890165438794
1088,36,51,87,0.00020819116575486647,0.0002366051338674733,0.00022552765694910332
1089,37,62,99,0.00021397425369250165,0.00028763761372124205,0.00025663491997656584
1090,36,53,89,0.00020819116575486647,0.0002458837665681585,0.00023071220078701375
1091,29,65,94,0.00016770955019142022,0.0003015555627722699,0.0002436735603817898
1092,52,37,89,0.00030072057275702934,0.0001716547049626767,0.00023071220078701375
1093,17,70,87,9.831249493979805e-05,0.00032475214452398293,0.00022552765694910332
1094,27,73,100,0.00015614337431614985,0.0003386700935750108,0.00025922719189552107
1095,23,60,83,0.00013301102256560912,0.0002783589810205568,0.0002151585692732825
1096,10,87,97,5.78308793763518e-05,0.0004036205224798074,0.00025145037613865545
1097,49,51,100,0.0002833713089441238,0.0002366051338674733,0.00025922719189552107
1098,17,72,89,9.831249493979805e-05,0.00033403077722466817,0.00023071220078701375
1099,69,23,92,0.0003990330676968274,0.00010670427605788011,0.0002384890165438794
1100,17,78,95,9.831249493979805e-05,0.00036186667532672387,0.000246265832300745
1101,90,8,98,0.0005204779143871661,3.711453080274091e-05,0.00025404264805761067
1102,1,93,94,5.783087937635179e-06,0.00043145642058186305,0.0002436735603817898
1103,27,50,77,0.00015614337431614985,0.00023196581751713067,0.00019960493775955123
1104,65,15,80,0.00037590071594628666,6.95897452551392e-05,0.00020738175351641685
1105,92,6,98,0.0005320440902624365,2.783589810205568e-05,0.00025404264805761067
1106,71,17,88,0.00041059924357209776,7.886837795582442e-05,0.00022811992886805855
1107,25,59,84,0.0001445771984408795,0.00027371966467021417,0.0002177508411922377
1108,1,106,107,5.783087937635179e-06,0.000491767533136317,0.00027737309532820754
1109,25,65,90,0.0001445771984408795,0.0003015555627722699,0.00023330447270596897
1110,36,53,89,0.00020819116575486647,0.0002458837665681585,0.00023071220078701375
1111,53,36,89,0.0003065036606946645,0.00016701538861233408,0.00023071220078701375
1112,1,88,89,5.783087937635179e-06,0.00040825983883015,0.00023071220078701375
1113,48,49,97,0.0002775882210064886,0.00022732650116678805,0.00025145037613865545
1114,17,91,108,9.831249493979805e-05,0.0004221777878811778,0.00027996536724716277
1115,110,3,113,0.0006361396731398698,1.391794905102784e-05,0.0002929267268419388
1116,45,27,72,0.00026023895719358306,0.00012526154145925056,0.00018664357816477518
1117,7,87,94,4.048161556344626e-05,0.0004036205224798074,0.0002436735603817898
1118,24,62,86,0.0001387941105032443,0.00028763761372124205,0.00022293538503014812
1119,77,5,82,0.00044529777119790885,2.319658175171307e-05,0.00021256629735432727
1120,13,54,67,7.518014318925733e-05,0.0002505230829185011,0.00017368221856999913
1121,6,86,92,3.4698527625811076e-05,0.00039898120612946476,0.0002384890165438794
1122,32,61,93,0.00018505881400432574,0.0002829982973708994,0.0002410812884628346
1123,3,84,87,1.7349263812905538e-05,0.0003897025734287795,0.00022552765694910332
1124,13,76,89,7.518014318925733e-05,0.00035258804262603864,0.00023071220078701375
1125,7,80,87,4.048161556344626e-05,0.0003711453080274091,0.00022552765694910332
1126,33,54,87,0.00019084190194196092,0.0002505230829185011,0.00022552765694910332
1127,48,45,93,0.0002775882210064886,0.0002087692357654176,0.0002410812884628346
1128,52,33,85,0.00030072057275702934,0.00015309743956130623,0.0002203431131111929
1129,27,62,89,0.00015614337431614985,0.00028763761372124205,0.00023071220078701375
1130,42,36,78,0.00024288969338067754,0.00016701538861233408,0.00020219720967850643
1131,30,51,81,0.0001734926381290554,0.0002366051338674733,0.00020997402543537208
1132,51,38,89,0.00029493748481939416,0.00017629402131301932,0.00023071220078701375
1133,103,2,105,0.0005956580575764235,9.278632700685228e-06,0.00027218855149029714
1134,50,51,101,0.000289154396881759,0.0002366051338674733,0.0002618194638144763
1135,1,89,90,5.783087937635179e-06,0.0004128991551804926,0.00023330447270596897
1136,22,84,106,0.00012722793462797397,0.0003897025734287795,0.0002747808234092523
1137,17,73,90,9.831249493979805e-05,0.0003386700935750108,0.00023330447270596897
1138,47,33,80,0.0002718051330688534,0.00015309743956130623,0.00020738175351641685
1139,17,65,82,9.831249493979805e-05,0.0003015555627722699,0.00021256629735432727
1140,3,74,77,1.7349263812905538e-05,0.0003433094099253534,0.00019960493775955123
1141,20,61,81,0.0001156617587527036,0.0002829982973708994,0.00020997402543537208
1142,1,105,106,5.783087937635179e-06,0.0004871282167859744,0.0002747808234092523
1143,71,31,102,0.00041059924357209776,0.00014381880686062103,0.00026441173573343147
1144,29,57,86,0.00016770955019142022,0.000264441031969529,0.00022293538503014812
1145,44,40,84,0.00025445586925594793,0.00018557265401370455,0.0002177508411922377
1146,12,70,82,6.939705525162215e-05,0.00032475214452398293,0.00021256629735432727
1147,14,78,92,8.096323112689252e-05,0.00036186667532672387,0.0002384890165438794
1148,55,33,88,0.0003180698365699349,0.00015309743956130623,0.00022811992886805855
1149,10,74,84,5.78308793763518e-05,0.0003433094099253534,0.0002177508411922377
1150,56,42,98,0.00032385292450757007,0.00019485128671438976,0.00025404264805761067
1151,1,80,81,5.783087937635179e-06,0.0003711453080274091,0.00020997402543537208
1152,35,47,82,0.0002024080778172313,0.00021804786846610285,0.00021256629735432727
1153,36,53,89,0.00020819116575486647,0.0002458837665681585,0.00023071220078701375
1154,66,19,85,0.00038168380388392184,8.814701065650966e-05,0.0002203431131111929
1155,70,22,92,0.0004048161556344626,0.0001020649597075375,0.0002384890165438794
1156,60,24,84,0.0003469852762581108,0.00011134359240822272,0.0002177508411922377
1157,1,89,90,5.783087937635179e-06,0.0004128991551804926,0.00023330447270596897
1158,9,79,88,5.204779143871662e-05,0.00036650599167706646,0.00022811992886805855
1159,60,27,87,0.0003469852762581108,0.00012526154145925056,0.00022552765694910332
1160,22,75,97,0.00012722793462797397,0.000347948726275696,0.00025145037613865545
1161,42,60,102,0.00024288969338067754,0.0002783589810205568,0.00026441173573343147
1162,31,65,96,0.00017927572606669058,0.0003015555627722699,0.0002488581042197002
1163,34,49,83,0.0001966249898795961,0.00022732650116678805,0.0002151585692732825
1164,4,73,77,2.3132351750540717e-05,0.0003386700935750108,0.00019960493775955123
1165,1,71,72,5.783087937635179e-06,0.0003293914608743256,0.00018664357816477518
1166,4,79,83,2.3132351750540717e-05,0.00036650599167706646,0.0002151585692732825
1167,27,58,85,0.00015614337431614985,0.0002690803483198716,0.0002203431131111929
1168,48,33,81,0.0002775882210064886,0.00015309743956130623,0.00020997402543537208
1169,29,41,70,0.00016770955019142022,0.00019021197036404714,0.00018145903432686475
1170,83,18,101,0.0004799962988237199,8.350769430616704e-05,0.0002618194638144763
1171,62,25,87,0.00035855145213338117,0.00011598290875856534,0.00022552765694910332
1172,31,46,77,0.00017927572606669058,0.00021340855211576023,0.00019960493775955123
1173,33,23,56,0.00019084190194196092,0.00010670427605788011,0.0001451672274614918
1174,10,67,77,5.78308793763518e-05,0.0003108341954729551,0.00019960493775955123
1175,77,14,91,0.00044529777119790885,6.495042890479659e-05,0.00023589674462492417
1176,56,26,82,0.00032385292450757007,0.00012062222510890795,0.00021256629735432727
1177,35,42,77,0.0002024080778172313,0.00019485128671438976,0.00019960493775955123
1178,32,51,83,0.00018505881400432574,0.0002366051338674733,0.0002151585692732825
1179,69,25,94,0.0003990330676968274,0.00011598290875856534,0.0002436735603817898
1180,6,80,86,3.4698527625811076e-05,0.0003711453080274091,0.00022293538503014812
1181,25,41,66,0.0001445771984408795,0.00019021197036404714,0.0001710899466510439
1182,37,35,72,0.00021397425369250165,0.00016237607226199147,0.00018664357816477518
1183,51,30,81,0.00029493748481939416,0.0001391794905102784,0.00020997402543537208
1184,31,54,85,0.00017927572606669058,0.0002505230829185011,0.0002203431131111929
1185,51,43,94,0.00029493748481939416,0.00019949060306473238,0.0002436735603817898
1186,94,9,103,0.0005436102661377069,4.175384715308352e-05,0.0002670040076523867
1187,105,1,106,0.0006072242334516939,4.639316350342614e-06,0.0002747808234092523
1188,56,37,93,0.00032385292450757007,0.0001716547049626767,0.0002410812884628346
1189,18,68,86,0.00010409558287743323,0.0003154735118232977,0.00022293538503014812
1190,26,60,86,0.00015036028637851467,0.0002783589810205568,0.00022293538503014812
1191,28,61,89,0.00016192646225378504,0.0002829982973708994,0.00023071220078701375
1192,1,119,120,5.783087937635179e-06,0.000552078645690771,0.00031107263027462526
1193,4,88,92,2.3132351750540717e-05,0.00040825983883015,0.0002384890165438794
1194,67,7,74,0.000387466891821557,3.247521445239829e-05,0.0001918281220026856
1195,20,63,83,0.0001156617587527036,0.00029227693007158464,0.0002151585692732825
1196,38,47,85,0.00021975734163013684,0.00021804786846610285,0.0002203431131111929
1197,53,30,83,0.0003065036606946645,0.0001391794905102784,0.0002151585692732825
1198,2,76,78,1.1566175875270359e-05,0.00035258804262603864,0.00020219720967850643
1199,1,95,96,5.783087937635179e-06,0.0004407350532825483,0.0002488581042197002
1200,71,19,90,0.00041059924357209776,8.814701065650966e-05,0.00023330447270596897
1201,16,68,84,9.252940700216287e-05,0.0003154735118232977,0.0002177508411922377
1202,23,57,80,0.00013301102256560912,0.000264441031969529,0.00020738175351641685
1203,98,5,103,0.0005667426178882476,2.319658175171307e-05,0.0002670040076523867
1204,23,74,97,0.00013301102256560912,0.0003433094099253534,0.00025145037613865545
1205,60,14,74,0.0003469852762581108,6.495042890479659e-05,0.0001918281220026856
1206,31,66,97,0.00017927572606669058,0.00030619487912261246,0.00025145037613865545
1207,12,59,71,6.939705525162215e-05,0.00027371966467021417,0.00018405130624581995
1208,40,44,84,0.0002313235175054072,0.000204129919415075,0.0002177508411922377
1209,62,18,80,0.00035855145213338117,8.350769430616704e-05,0.00020738175351641685
1210,67,33,100,0.000387466891821557,0.00015309743956130623,0.00025922719189552107
1211,41,45,86,0.00023710660544304236,0.0002087692357654176,0.00022293538503014812
1212,36,40,76,0.00020819116575486647,0.00018557265401370455,0.00019701266584059603
1213,23,61,84,0.00013301102256560912,0.0002829982973708994,0.0002177508411922377
1214,25,60,85,0.0001445771984408795,0.0002783589810205568,0.0002203431131111929
1215,2,83,85,1.1566175875270359e-05,0.00038506325707843693,0.0002203431131111929
1216,82,11,93,0.0004742132108860847,5.103247985376875e-05,0.0002410812884628346
1217,30,54,84,0.0001734926381290554,0.0002505230829185011,0.0002177508411922377
1218,45,48,93,0.00026023895719358306,0.00022268718481644544,0.0002410812884628346
1219,57,27,84,0.00032963601244520525,0.00012526154145925056,0.0002177508411922377
1220,41,31,72,0.00023710660544304236,0.00014381880686062103,0.00018664357816477518
1221,52,19,71,0.00030072057275702934,8.814701065650966e-05,0.00018405130624581995
1222,22,64,86,0.00012722793462797397,0.0002969162464219273,0.00022293538503014812
1223,4,69,73,2.3132351750540717e-05,0.00032011282817364034,0.00018923585008373038
1224,39,54,93,0.00022554042956777202,0.0002505230829185011,0.0002410812884628346
1225,67,28,95,0.000387466891821557,0.00012990085780959317,0.000246265832300745
1226,46,46,92,0.00026602204513121824,0.00021340855211576023,0.0002384890165438794
1227,36,42,78,0.00020819116575486647,0.00019485128671438976,0.00020219720967850643
1228,68,6,74,0.0003932499797591922,2.783589810205568e-05,0.0001918281220026856
1229,69,13,82,0.0003990330676968274,6.0311112554453976e-05,0.00021256629735432727
1230,11,65,76,6.361396731398698e-05,0.0003015555627722699,0.00019701266584059603
1231,10,68,78,5.78308793763518e-05,0.0003154735118232977,0.00020219720967850643
1232,52,30,82,0.00030072057275702934,0.0001391794905102784,0.00021256629735432727
1233,70,12,82,0.0004048161556344626,5.567179620411136e-05,0.00021256629735432727
1234,15,68,83,8.67463190645277e-05,0.0003154735118232977,0.0002151585692732825
1235,12,66,78,6.939705525162215e-05,0.00030619487912261246,0.00020219720967850643
1236,71,20,91,0.00041059924357209776,9.278632700685228e-05,0.00023589674462492417
1237,22,69,91,0.00012722793462797397,0.00032011282817364034,0.00023589674462492417
1238,28,56,84,0.00016192646225378504,0.00025980171561918635,0.0002177508411922377
1239,17,57,74,9.831249493979805e-05,0.000264441031969529,0.0001918281220026856
1240,6,74,80,3.4698527625811076e-05,0.0003433094099253534,0.00020738175351641685
1241,30,57,87,0.0001734926381290554,0.000264441031969529,0.00022552765694910332
1242,53,30,83,0.0003065036606946645,0.0001391794905102784,0.0002151585692732825
1243,39,38,77,0.00022554042956777202,0.00017629402131301932,0.00019960493775955123
1244,28,50,78,0.00016192646225378504,0.00023196581751713067,0.00020219720967850643
1245,69,5,74,0.0003990330676968274,2.319658175171307e-05,0.0001918281220026856
1246,7,69,76,4.048161556344626e-05,0.00032011282817364034,0.00019701266584059603
1247,32,53,85,0.00018505881400432574,0.0002458837665681585,0.0002203431131111929
1248,29,53,82,0.00016770955019142022,0.0002458837665681585,0.00021256629735432727
1249,26,49,75,0.00015036028637851467,0.00022732650116678805,0.0001944203939216408
1250,43,32,75,0.00024867278131831275,0.00014845812321096364,0.0001944203939216408
1251,34,45,79,0.0001966249898795961,0.0002087692357654176,0.00020478948159746165
1252,45,39,84,0.00026023895719358306,0.00018093333766336194,0.0002177508411922377
1253,3,76,79,1.7349263812905538e-05,0.00035258804262603864,0.00020478948159746165
1254,13,60,73,7.518014318925733e-05,0.0002783589810205568,0.00018923585008373038
1255,41,37,78,0.00023710660544304236,0.0001716547049626767,0.00020219720967850643
1256,18,65,83,0.00010409558287743323,0.0003015555627722699,0.0002151585692732825
1257,51,14,65,0.00029493748481939416,6.495042890479659e-05,0.0001684976747320887
1258,24,37,61,0.0001387941105032443,0.0001716547049626767,0.00015812858705626786
1259,48,43,91,0.0002775882210064886,0.00019949060306473238,0.00023589674462492417
1260,29,47,76,0.00016770955019142022,0.00021804786846610285,0.00019701266584059603
1261,16,69,85,9.252940700216287e-05,0.00032011282817364034,0.0002203431131111929
1262,1,106,107,5.783087937635179e-06,0.000491767533136317,0.00027737309532820754
1263,37,43,80,0.00021397425369250165,0.00019949060306473238,0.00020738175351641685
1264,33,31,64,0.00019084190194196092,0.00014381880686062103,0.00016590540281313348
1265,74,10,84,0.0004279485073850033,4.639316350342614e-05,0.0002177508411922377
1266,5,76,81,2.89154396881759e-05,0.00035258804262603864,0.00020997402543537208
1267,37,50,87,0.00021397425369250165,0.00023196581751713067,0.00022552765694910332
1268,26,43,69,0.00015036028637851467,0.00019949060306473238,0.00017886676240790953
1269,42,20,62,0.00024288969338067754,9.278632700685228e-05,0.00016072085897522306
1270,43,31,74,0.00024867278131831275,0.00014381880686062103,0.0001918281220026856
1271,7,71,78,4.048161556344626e-05,0.0003293914608743256,0.00020219720967850643
1272,48,26,74,0.0002775882210064886,0.00012062222510890795,0.0001918281220026856
1273,11,56,67,6.361396731398698e-05,0.00025980171561918635,0.00017368221856999913
1274,11,72,83,6.361396731398698e-05,0.00033403077722466817,0.0002151585692732825
1275,37,42,79,0.00021397425369250165,0.00019485128671438976,0.00020478948159746165
1276,36,33,69,0.00020819116575486647,0.00015309743956130623,0.00017886676240790953
1277,89,6,95,0.000514694826449531,2.783589810205568e-05,0.000246265832300745
1278,1,83,84,5.783087937635179e-06,0.00038506325707843693,0.0002177508411922377
1279,8,68,76,4.6264703501081435e-05,0.0003154735118232977,0.00019701266584059603
1280,34,43,77,0.0001966249898795961,0.00019949060306473238,0.00019960493775955123
1281,15,51,66,8.67463190645277e-05,0.0002366051338674733,0.0001710899466510439
1282,65,18,83,0.00037590071594628666,8.350769430616704e-05,0.0002151585692732825
1283,55,1,56,0.0003180698365699349,4.639316350342614e-06,0.0001451672274614918
1284,45,20,65,0.00026023895719358306,9.278632700685228e-05,0.0001684976747320887
1285,65,20,85,0.00037590071594628666,9.278632700685228e-05,0.0002203431131111929
1286,37,34,71,0.00021397425369250165,0.00015773675591164885,0.00018405130624581995
1287,27,60,87,0.00015614337431614985,0.0002783589810205568,0.00022552765694910332
1288,37,45,82,0.00021397425369250165,0.0002087692357654176,0.00021256629735432727
1289,58,29,87,0.00033541910038284044,0.0001345401741599358,0.00022552765694910332
1290,1,75,76,5.783087937635179e-06,0.000347948726275696,0.00019701266584059603
1291,92,4,96,0.0005320440902624365,1.8557265401370455e-05,0.0002488581042197002
1292,54,23,77,0.0003122867486322997,0.00010670427605788011,0.00019960493775955123
1293,35,47,82,0.0002024080778172313,0.00021804786846610285,0.00021256629735432727
1294,17,49,66,9.831249493979805e-05,0.00022732650116678805,0.0001710899466510439
1295,39,38,77,0.00022554042956777202,0.00017629402131301932,0.00019960493775955123
1296,56,22,78,0.00032385292450757007,0.0001020649597075375,0.00020219720967850643
1297,17,48,65,9.831249493979805e-05,0.00022268718481644544,0.0001684976747320887
1298,98,1,99,0.0005667426178882476,4.639316350342614e-06,0.00025663491997656584
1299,79,12,91,0.0004568639470731792,5.567179620411136e-05,0.00023589674462492417
1300,32,46,78,0.00018505881400432574,0.00021340855211576023,0.00020219720967850643
1301,36,42,78,0.00020819116575486647,0.00019485128671438976,0.00020219720967850643
1302,13,59,72,7.518014318925733e-05,0.00027371966467021417,0.00018664357816477518
1303,14,68,82,8.096323112689252e-05,0.0003154735118232977,0.00021256629735432727
1304,19,59,78,0.00010987867081506842,0.00027371966467021417,0.00020219720967850643
1305,44,29,73,0.00025445586925594793,0.0001345401741599358,0.00018923585008373038
1306,27,53,80,0.00015614337431614985,0.0002458837665681585,0.00020738175351641685
1307,58,15,73,0.00033541910038284044,6.95897452551392e-05,0.00018923585008373038
1308,61,16,77,0.000352768364195746,7.422906160548182e-05,0.00019960493775955123
1309,46,36,82,0.00026602204513121824,0.00016701538861233408,0.00021256629735432727
1310,61,14,75,0.000352768364195746,6.495042890479659e-05,0.0001944203939216408
1311,80,6,86,0.0004626470350108144,2.783589810205568e-05,0.00022293538503014812
1312,45,45,90,0.00026023895719358306,0.0002087692357654176,0.00023330447270596897
1313,65,12,77,0.00037590071594628666,5.567179620411136e-05,0.00019960493775955123
1314,28,47,75,0.00016192646225378504,0.00021804786846610285,0.0001944203939216408
1315,54,30,84,0.0003122867486322997,0.0001391794905102784,0.0002177508411922377
1316,23,59,82,0.00013301102256560912,0.00027371966467021417,0.00021256629735432727
1317,20,48,68,0.0001156617587527036,0.00022268718481644544,0.00017627449048895433
1318,96,1,97,0.0005551764420129772,4.639316350342614e-06,0.00025145037613865545
1319,19,58,77,0.00010987867081506842,0.0002690803483198716,0.00019960493775955123
1320,19,57,76,0.00010987867081506842,0.000264441031969529,0.00019701266584059603
1321,40,37,77,0.0002313235175054072,0.0001716547049626767,0.00019960493775955123
1322,4,72,76,2.3132351750540717e-05,0.00033403077722466817,0.00019701266584059603
1323,48,33,81,0.0002775882210064886,0.00015309743956130623,0.00020997402543537208
1324,40,41,81,0.0002313235175054072,0.00019021197036404714,0.00020997402543537208
1325,4,69,73,2.3132351750540717e-05,0.00032011282817364034,0.00018923585008373038
1326,1,78,79,5.783087937635179e-06,0.00036186667532672387,0.00020478948159746165
1327,61,17,78,0.000352768364195746,7.886837795582442e-05,0.00020219720967850643
1328,47,40,87,0.0002718051330688534,0.00018557265401370455,0.00022552765694910332
1329,29,47,76,0.00016770955019142022,0.00021804786846610285,0.00019701266584059603
1330,65,23,88,0.00037590071594628666,0.00010670427605788011,0.00022811992886805855
1331,25,51,76,0.0001445771984408795,0.0002366051338674733,0.00019701266584059603
1332,25,41,66,0.0001445771984408795,0.00019021197036404714,0.0001710899466510439
1333,1,72,73,5.783087937635179e-06,0.00033403077722466817,0.00018923585008373038
1334,28,43,71,0.00016192646225378504,0.00019949060306473238,0.00018405130624581995
1335,15,43,58,8.67463190645277e-05,0.00019949060306473238,0.00015035177129940223
1336,30,48,78,0.0001734926381290554,0.00022268718481644544,0.00020219720967850643
1337,40,21,61,0.0002313235175054072,9.742564335719488e-05,0.00015812858705626786
1338,17,52,69,9.831249493979805e-05,0.0002412444502178159,0.00017886676240790953
1339,1,29,30,5.783087937635179e-06,0.0001345401741599358,7.776815756865632e-05
1340,24,50,74,0.0001387941105032443,0.00023196581751713067,0.0001918281220026856
1341,26,44,70,0.00015036028637851467,0.000204129919415075,0.00018145903432686475
1342,58,23,81,0.00033541910038284044,0.00010670427605788011,0.00020997402543537208
1343,15,46,61,8.67463190645277e-05,0.00021340855211576023,0.00015812858705626786
1344,2,77,79,1.1566175875270359e-05,0.00035722735897638123,0.00020478948159746165
1345,34,38,72,0.0001966249898795961,0.00017629402131301932,0.00018664357816477518
1346,24,65,89,0.0001387941105032443,0.0003015555627722699,0.00023071220078701375
1347,40,29,69,0.0002313235175054072,0.0001345401741599358,0.00017886676240790953
1348,74,1,75,0.0004279485073850033,4.639316350342614e-06,0.0001944203939216408
1349,45,39,84,0.00026023895719358306,0.00018093333766336194,0.0002177508411922377
1350,36,36,72,0.00020819116575486647,0.00016701538861233408,0.00018664357816477518
1351,44,35,79,0.00025445586925594793,0.00016237607226199147,0.00020478948159746165
1352,37,46,83,0.00021397425369250165,0.00021340855211576023,0.0002151585692732825
1353,11,53,64,6.361396731398698e-05,0.0002458837665681585,0.00016590540281313348
1354,10,74,84,5.78308793763518e-05,0.0003433094099253534,0.0002177508411922377
1355,20,50,70,0.0001156617587527036,0.00023196581751713067,0.00018145903432686475
1356,15,52,67,8.67463190645277e-05,0.0002412444502178159,0.00017368221856999913
1357,23,51,74,0.00013301102256560912,0.0002366051338674733,0.0001918281220026856
1358,20,37,57,0.0001156617587527036,0.0001716547049626767,0.000147759499380447
1359,1,83,84,5.783087937635179e-06,0.00038506325707843693,0.0002177508411922377
1360,21,43,64,0.00012144484669033877,0.00019949060306473238,0.00016590540281313348
1361,6,56,62,3.4698527625811076e-05,0.00025980171561918635,0.00016072085897522306
1362,71,5,76,0.00041059924357209776,2.319658175171307e-05,0.00019701266584059603
1363,65,13,78,0.00037590071594628666,6.0311112554453976e-05,0.00020219720967850643
1364,51,26,77,0.00029493748481939416,0.00012062222510890795,0.00019960493775955123
1365,18,46,64,0.00010409558287743323,0.00021340855211576023,0.00016590540281313348
1366,30,34,64,0.0001734926381290554,0.00015773675591164885,0.00016590540281313348
1367,26,43,69,0.00015036028637851467,0.00019949060306473238,0.00017886676240790953
1368,13,35,48,7.518014318925733e-05,0.00016237607226199147,0.0001244290521098501
1369,58,37,95,0.00033541910038284044,0.0001716547049626767,0.000246265832300745
1370,16,60,76,9.252940700216287e-05,0.0002783589810205568,0.00019701266584059603
1371,4,72,76,2.3132351750540717e-05,0.00033403077722466817,0.00019701266584059603
1372,33,36,69,0.00019084190194196092,0.00016701538861233408,0.00017886676240790953
1373,66,7,73,0.00038168380388392184,3.247521445239829e-05,0.00018923585008373038
1374,25,37,62,0.0001445771984408795,0.0001716547049626767,0.00016072085897522306
1375,31,45,76,0.00017927572606669058,0.0002087692357654176,0.00019701266584059603
1376,25,43,68,0.0001445771984408795,0.00019949060306473238,0.00017627449048895433
1377,7,76,83,4.048161556344626e-05,0.00035258804262603864,0.0002151585692732825
1378,24,43,67,0.0001387941105032443,0.00019949060306473238,0.00017368221856999913
1379,17,40,57,9.831249493979805e-05,0.00018557265401370455,0.000147759499380447
1380,40,27,67,0.0002313235175054072,0.00012526154145925056,0.00017368221856999913
1381,11,70,81,6.361396731398698e-05,0.00032475214452398293,0.00020997402543537208
1382,35,36,71,0.0002024080778172313,0.00016701538861233408,0.00018405130624581995
1383,45,33,78,0.00026023895719358306,0.00015309743956130623,0.00020219720967850643
1384,54,21,75,0.0003122867486322997,9.742564335719488e-05,0.0001944203939216408
1385,2,77,79,1.1566175875270359e-05,0.00035722735897638123,0.00020478948159746165
1386,43,32,75,0.00024867278131831275,0.00014845812321096364,0.0001944203939216408
1387,55,13,68,0.0003180698365699349,6.0311112554453976e-05,0.00017627449048895433
1388,72,4,76,0.00041638233150973294,1.8557265401370455e-05,0.00019701266584059603
1389,53,7,60,0.0003065036606946645,3.247521445239829e-05,0.00015553631513731263
1390,9,71,80,5.204779143871662e-05,0.0003293914608743256,0.00020738175351641685
1391,6,41,47,3.4698527625811076e-05,0.00019021197036404714,0.0001218367801908949
1392,26,52,78,0.00015036028637851467,0.0002412444502178159,0.00020219720967850643
1393,55,14,69,0.0003180698365699349,6.495042890479659e-05,0.00017886676240790953
1394,28,44,72,0.00016192646225378504,0.000204129919415075,0.00018664357816477518
1395,61,18,79,0.000352768364195746,8.350769430616704e-05,0.00020478948159746165
1396,24,38,62,0.0001387941105032443,0.00017629402131301932,0.00016072085897522306
1397,32,39,71,0.00018505881400432574,0.00018093333766336194,0.00018405130624581995
1398,17,60,77,9.831249493979805e-05,0.0002783589810205568,0.00019960493775955123
1399,18,45,63,0.00010409558287743323,0.0002087692357654176,0.00016331313089417828
1400,2,75,77,1.1566175875270359e-05,0.000347948726275696,0.00019960493775955123
1401,17,60,77,9.831249493979805e-05,0.0002783589810205568,0.00019960493775955123
1402,9,59,68,5.204779143871662e-05,0.00027371966467021417,0.00017627449048895433
1403,1,61,62,5.783087937635179e-06,0.0002829982973708994,0.00016072085897522306
1404,28,49,77,0.00016192646225378504,0.00022732650116678805,0.00019960493775955123
1405,47,24,71,0.0002718051330688534,0.00011134359240822272,0.00018405130624581995
1406,23,65,88,0.00013301102256560912,0.0003015555627722699,0.00022811992886805855
1407,14,62,76,8.096323112689252e-05,0.00028763761372124205,0.00019701266584059603
1408,36,42,78,0.00020819116575486647,0.00019485128671438976,0.00020219720967850643
1409,51,15,66,0.00029493748481939416,6.95897452551392e-05,0.0001710899466510439
1410,14,56,70,8.096323112689252e-05,0.00025980171561918635,0.00018145903432686475
1411,1,55,56,5.783087937635179e-06,0.00025516239926884376,0.0001451672274614918
1412,51,14,65,0.00029493748481939416,6.495042890479659e-05,0.0001684976747320887
1413,20,56,76,0.0001156617587527036,0.00025980171561918635,0.00019701266584059603
1414,11,66,77,6.361396731398698e-05,0.00030619487912261246,0.00019960493775955123
1415,38,31,69,0.00021975734163013684,0.00014381880686062103,0.00017886676240790953
1416,22,51,73,0.00012722793462797397,0.0002366051338674733,0.00018923585008373038
1417,32,45,77,0.00018505881400432574,0.0002087692357654176,0.00019960493775955123
1418,28,47,75,0.00016192646225378504,0.00021804786846610285,0.0001944203939216408
1419,27,47,74,0.00015614337431614985,0.00021804786846610285,0.0001918281220026856
1420,6,60,66,3.4698527625811076e-05,0.0002783589810205568,0.0001710899466510439
1421,11,58,69,6.361396731398698e-05,0.0002690803483198716,0.00017886676240790953
1422,9,39,48,5.204779143871662e-05,0.00018093333766336194,0.0001244290521098501
1423,29,33,62,0.00016770955019142022,0.00015309743956130623,0.00016072085897522306
1424,48,39,87,0.0002775882210064886,0.00018093333766336194,0.00022552765694910332
1425,19,52,71,0.00010987867081506842,0.0002412444502178159,0.00018405130624581995
1426,15,62,77,8.67463190645277e-05,0.00028763761372124205,0.00019960493775955123
1427,56,22,78,0.00032385292450757007,0.0001020649597075375,0.00020219720967850643
1428,77,5,82,0.00044529777119790885,2.319658175171307e-05,0.00021256629735432727
1429,62,9,71,0.00035855145213338117,4.175384715308352e-05,0.00018405130624581995
1430,6,71,77,3.4698527625811076e-05,0.0003293914608743256,0.00019960493775955123
1431,22,40,62,0.00012722793462797397,0.00018557265401370455,0.00016072085897522306
1432,8,59,67,4.6264703501081435e-05,0.00027371966467021417,0.00017368221856999913
1433,4,56,60,2.3132351750540717e-05,0.00025980171561918635,0.00015553631513731263
1434,55,15,70,0.0003180698365699349,6.95897452551392e-05,0.00018145903432686475
1435,43,23,66,0.00024867278131831275,0.00010670427605788011,0.0001710899466510439
1436,33,46,79,0.00019084190194196092,0.00021340855211576023,0.00020478948159746165
1437,15,53,68,8.67463190645277e-05,0.0002458837665681585,0.00017627449048895433
1438,55,7,62,0.0003180698365699349,3.247521445239829e-05,0.00016072085897522306
1439,42,31,73,0.00024288969338067754,0.00014381880686062103,0.00018923585008373038
1440,1,54,55,5.783087937635179e-06,0.0002505230829185011,0.00014257495554253658
1441,19,52,71,0.00010987867081506842,0.0002412444502178159,0.00018405130624581995
1442,16,54,70,9.252940700216287e-05,0.0002505230829185011,0.00018145903432686475
1443,32,35,67,0.00018505881400432574,0.00016237607226199147,0.00017368221856999913
1444,30,32,62,0.0001734926381290554,0.00014845812321096364,0.00016072085897522306
1445,7,65,72,4.048161556344626e-05,0.0003015555627722699,0.00018664357816477518
1446,31,39,70,0.00017927572606669058,0.00018093333766336194,0.00018145903432686475
1447,41,38,79,0.00023710660544304236,0.00017629402131301932,0.00020478948159746165
1448,7,59,66,4.048161556344626e-05,0.00027371966467021417,0.0001710899466510439
1449,20,57,77,0.0001156617587527036,0.000264441031969529,0.00019960493775955123
1450,37,31,68,0.00021397425369250165,0.00014381880686062103,0.00017627449048895433
1451,24,53,77,0.0001387941105032443,0.0002458837665681585,0.00019960493775955123
1452,10,68,78,5.78308793763518e-05,0.0003154735118232977,0.00020219720967850643
1453,10,58,68,5.78308793763518e-05,0.0002690803483198716,0.00017627449048895433
1454,16,52,68,9.252940700216287e-05,0.0002412444502178159,0.00017627449048895433
1455,73,9,82,0.0004221654194473681,4.175384715308352e-05,0.00021256629735432727
1456,50,1,51,0.000289154396881759,4.639316350342614e-06,0.00013220586786671573
1457,2,64,66,1.1566175875270359e-05,0.0002969162464219273,0.0001710899466510439
1458,33,54,87,0.00019084190194196092,0.0002505230829185011,0.00022552765694910332
1459,66,2,68,0.00038168380388392184,9.278632700685228e-06,0.00017627449048895433
1460,44,26,70,0.00025445586925594793,0.00012062222510890795,0.00018145903432686475
1461,31,35,66,0.00017927572606669058,0.00016237607226199147,0.0001710899466510439
1462,16,49,65,9.252940700216287e-05,0.00022732650116678805,0.0001684976747320887
1463,15,56,71,8.67463190645277e-05,0.00025980171561918635,0.00018405130624581995
1464,23,51,74,0.00013301102256560912,0.0002366051338674733,0.0001918281220026856
1465,26,41,67,0.00015036028637851467,0.00019021197036404714,0.00017368221856999913
1466,28,40,68,0.00016192646225378504,0.00018557265401370455,0.00017627449048895433
1467,36,36,72,0.00020819116575486647,0.00016701538861233408,0.00018664357816477518
1468,41,25,66,0.00023710660544304236,0.00011598290875856534,0.0001710899466510439
1469,63,15,78,0.0003643345400710163,6.95897452551392e-05,0.00020219720967850643
1470,31,37,68,0.00017927572606669058,0.0001716547049626767,0.00017627449048895433
1471,19,47,66,0.00010987867081506842,0.00021804786846610285,0.0001710899466510439
1472,50,26,76,0.000289154396881759,0.00012062222510890795,0.00019701266584059603
1473,42,33,75,0.00024288969338067754,0.00015309743956130623,0.0001944203939216408
1474,5,55,60,2.89154396881759e-05,0.00025516239926884376,0.00015553631513731263
1475,36,30,66,0.00020819116575486647,0.0001391794905102784,0.0001710899466510439
1476,9,56,65,5.204779143871662e-05,0.00025980171561918635,0.0001684976747320887
1477,51,28,79,0.00029493748481939416,0.00012990085780959317,0.00020478948159746165
1478,14,51,65,8.096323112689252e-05,0.0002366051338674733,0.0001684976747320887
1479,64,18,82,0.0003701176280086515,8.350769430616704e-05,0.00021256629735432727
1480,49,27,76,0.0002833713089441238,0.00012526154145925056,0.00019701266584059603
1481,16,49,65,9.252940700216287e-05,0.00022732650116678805,0.0001684976747320887
1482,34,30,64,0.0001966249898795961,0.0001391794905102784,0.00016590540281313348
1483,23,38,61,0.00013301102256560912,0.00017629402131301932,0.00015812858705626786
1484,2,83,85,1.1566175875270359e-05,0.00038506325707843693,0.0002203431131111929
1485,37,36,73,0.00021397425369250165,0.00016701538861233408,0.00018923585008373038
1486,25,48,73,0.0001445771984408795,0.00022268718481644544,0.00018923585008373038
1487,22,45,67,0.00012722793462797397,0.0002087692357654176,0.00017368221856999913
1488,11,58,69,6.361396731398698e-05,0.0002690803483198716,0.00017886676240790953
1489,39,28,67,0.00022554042956777202,0.00012990085780959317,0.00017368221856999913
1490,43,1,44,0.00024867278131831275,4.639316350342614e-06,0.00011405996443402927
1491,15,57,72,8.67463190645277e-05,0.000264441031969529,0.00018664357816477518
1492,23,47,70,0.00013301102256560912,0.00021804786846610285,0.00018145903432686475
1493,26,30,56,0.00015036028637851467,0.0001391794905102784,0.0001451672274614918
1494,1,77,78,5.783087937635179e-06,0.00035722735897638123,0.00020219720967850643
1495,59,5,64,0.0003412021883204756,2.319658175171307e-05,0.00016590540281313348
1496,22,45,67,0.00012722793462797397,0.0002087692357654176,0.00017368221856999913
1497,25,41,66,0.0001445771984408795,0.00019021197036404714,0.0001710899466510439
1498,3,60,63,1.7349263812905538e-05,0.0002783589810205568,0.00016331313089417828
1499,80,5,85,0.0004626470350108144,2.319658175171307e-05,0.0002203431131111929
1500,20,49,69,0.0001156617587527036,0.00022732650116678805,0.00017886676240790953
1501,37,32,69,0.00021397425369250165,0.00014845812321096364,0.00017886676240790953
1502,26,38,64,0.00015036028637851467,0.00017629402131301932,0.00016590540281313348
1503,27,35,62,0.00015614337431614985,0.00016237607226199147,0.00016072085897522306
1504,44,21,65,0.00025445586925594793,9.742564335719488e-05,0.0001684976747320887
1505,4,59,63,2.3132351750540717e-05,0.00027371966467021417,0.00016331313089417828
1506,28,24,52,0.00016192646225378504,0.00011134359240822272,0.00013479813978567096
1507,55,14,69,0.0003180698365699349,6.495042890479659e-05,0.00017886676240790953
1508,55,17,72,0.0003180698365699349,7.886837795582442e-05,0.00018664357816477518
1509,32,25,57,0.00018505881400432574,0.00011598290875856534,0.000147759499380447
1510,3,64,67,1.7349263812905538e-05,0.0002969162464219273,0.00017368221856999913
1511,29,33,62,0.00016770955019142022,0.00015309743956130623,0.00016072085897522306
1512,9,43,52,5.204779143871662e-05,0.00019949060306473238,0.00013479813978567096
1513,8,59,67,4.6264703501081435e-05,0.00027371966467021417,0.00017368221856999913
1514,42,19,61,0.00024288969338067754,8.814701065650966e-05,0.00015812858705626786
1515,17,45,62,9.831249493979805e-05,0.0002087692357654176,0.00016072085897522306
1516,20,46,66,0.0001156617587527036,0.00021340855211576023,0.0001710899466510439
1517,69,1,70,0.0003990330676968274,4.639316350342614e-06,0.00018145903432686475
1518,57,4,61,0.00032963601244520525,1.8557265401370455e-05,0.00015812858705626786
1519,48,20,68,0.0002775882210064886,9.278632700685228e-05,0.00017627449048895433
1520,7,52,59,4.048161556344626e-05,0.0002412444502178159,0.00015294404321835743
1521,6,53,59,3.4698527625811076e-05,0.0002458837665681585,0.00015294404321835743
1522,7,62,69,4.048161556344626e-05,0.00028763761372124205,0.00017886676240790953
1523,15,53,68,8.67463190645277e-05,0.0002458837665681585,0.00017627449048895433
1524,50,17,67,0.000289154396881759,7.886837795582442e-05,0.00017368221856999913
1525,5,52,57,2.89154396881759e-05,0.0002412444502178159,0.000147759499380447
1526,1,47,48,5.783087937635179e-06,0.00021804786846610285,0.0001244290521098501
1527,21,42,63,0.00012144484669033877,0.00019485128671438976,0.00016331313089417828
1528,23,47,70,0.00013301102256560912,0.00021804786846610285,0.00018145903432686475
1529,7,51,58,4.048161556344626e-05,0.0002366051338674733,0.00015035177129940223
1530,9,64,73,5.204779143871662e-05,0.0002969162464219273,0.00018923585008373038
1531,42,23,65,0.00024288969338067754,0.00010670427605788011,0.0001684976747320887
1532,13,53,66,7.518014318925733e-05,0.0002458837665681585,0.0001710899466510439
1533,41,19,60,0.00023710660544304236,8.814701065650966e-05,0.00015553631513731263
1534,35,26,61,0.0002024080778172313,0.00012062222510890795,0.00015812858705626786
1535,41,9,50,0.00023710660544304236,4.175384715308352e-05,0.00012961359594776053
1536,19,39,58,0.00010987867081506842,0.00018093333766336194,0.00015035177129940223
1537,10,59,69,5.78308793763518e-05,0.00027371966467021417,0.00017886676240790953
1538,9,67,76,5.204779143871662e-05,0.0003108341954729551,0.00019701266584059603
1539,35,23,58,0.0002024080778172313,0.00010670427605788011,0.00015035177129940223
1540,45,22,67,0.00026023895719358306,0.0001020649597075375,0.00017368221856999913
1541,15,49,64,8.67463190645277e-05,0.00022732650116678805,0.00016590540281313348
1542,39,20,59,0.00022554042956777202,9.278632700685228e-05,0.00015294404321835743
1543,17,52,69,9.831249493979805e-05,0.0002412444502178159,0.00017886676240790953
1544,37,30,67,0.00021397425369250165,0.0001391794905102784,0.00017368221856999913
1545,4,44,48,2.3132351750540717e-05,0.000204129919415075,0.0001244290521098501
1546,40,28,68,0.0002313235175054072,0.00012990085780959317,0.00017627449048895433
1547,2,58,60,1.1566175875270359e-05,0.0002690803483198716,0.00015553631513731263
1548,46,1,47,0.00026602204513121824,4.639316350342614e-06,0.0001218367801908949
1549,38,28,66,0.00021975734163013684,0.00012990085780959317,0.0001710899466510439
1550,14,50,64,8.096323112689252e-05,0.00023196581751713067,0.00016590540281313348
1551,1,70,71,5.783087937635179e-06,0.00032475214452398293,0.00018405130624581995
1552,60,6,66,0.0003469852762581108,2.783589810205568e-05,0.0001710899466510439
1553,53,9,62,0.0003065036606946645,4.175384715308352e-05,0.00016072085897522306
1554,2,49,51,1.1566175875270359e-05,0.00022732650116678805,0.00013220586786671573
1555,1,62,63,5.783087937635179e-06,0.00028763761372124205,0.00016331313089417828
1556,29,29,58,0.00016770955019142022,0.0001345401741599358,0.00015035177129940223
1557,24,42,66,0.0001387941105032443,0.00019485128671438976,0.0001710899466510439
1558,1,65,66,5.783087937635179e-06,0.0003015555627722699,0.0001710899466510439
1559,46,21,67,0.00026602204513121824,9.742564335719488e-05,0.00017368221856999913
1560,26,33,59,0.00015036028637851467,0.00015309743956130623,0.00015294404321835743
1561,4,67,71,2.3132351750540717e-05,0.0003108341954729551,0.00018405130624581995
1562,1,64,65,5.783087937635179e-06,0.0002969162464219273,0.0001684976747320887
1563,23,35,58,0.00013301102256560912,0.00016237607226199147,0.00015035177129940223
1564,45,28,73,0.00026023895719358306,0.00012990085780959317,0.00018923585008373038
1565,12,52,64,6.939705525162215e-05,0.0002412444502178159,0.00016590540281313348
1566,45,9,54,0.00026023895719358306,4.175384715308352e-05,0.00013998268362358138
1567,24,40,64,0.0001387941105032443,0.00018557265401370455,0.00016590540281313348
1568,20,40,60,0.0001156617587527036,0.00018557265401370455,0.00015553631513731263
1569,46,17,63,0.00026602204513121824,7.886837795582442e-05,0.00016331313089417828
1570,22,45,67,0.00012722793462797397,0.0002087692357654176,0.00017368221856999913
1571,21,36,57,0.00012144484669033877,0.00016701538861233408,0.000147759499380447
1572,2,51,53,1.1566175875270359e-05,0.0002366051338674733,0.00013739041170462616
1573,42,20,62,0.00024288969338067754,9.278632700685228e-05,0.00016072085897522306
1574,31,35,66,0.00017927572606669058,0.00016237607226199147,0.0001710899466510439
1575,25,40,65,0.0001445771984408795,0.00018557265401370455,0.0001684976747320887
1576,2,71,73,1.1566175875270359e-05,0.0003293914608743256,0.00018923585008373038
1577,20,46,66,0.0001156617587527036,0.00021340855211576023,0.0001710899466510439
1578,52,10,62,0.00030072057275702934,4.639316350342614e-05,0.00016072085897522306
1579,27,27,54,0.00015614337431614985,0.00012526154145925056,0.00013998268362358138
1580,30,40,70,0.0001734926381290554,0.00018557265401370455,0.00018145903432686475
1581,17,43,60,9.831249493979805e-05,0.00019949060306473238,0.00015553631513731263
1582,9,66,75,5.204779143871662e-05,0.00030619487912261246,0.0001944203939216408
1583,16,46,62,9.252940700216287e-05,0.00021340855211576023,0.00016072085897522306
1584,40,24,64,0.0002313235175054072,0.00011134359240822272,0.00016590540281313348
1585,6,58,64,3.4698527625811076e-05,0.0002690803483198716,0.00016590540281313348
1586,24,32,56,0.0001387941105032443,0.00014845812321096364,0.0001451672274614918
1587,44,24,68,0.00025445586925594793,0.00011134359240822272,0.00017627449048895433
1588,21,40,61,0.00012144484669033877,0.00018557265401370455,0.00015812858705626786
1589,58,3,61,0.00033541910038284044,1.391794905102784e-05,0.00015812858705626786
1590,4,63,67,2.3132351750540717e-05,0.00029227693007158464,0.00017368221856999913
1591,10,57,67,5.78308793763518e-05,0.000264441031969529,0.00017368221856999913
1592,11,57,68,6.361396731398698e-05,0.000264441031969529,0.00017627449048895433
1593,48,25,73,0.0002775882210064886,0.00011598290875856534,0.00018923585008373038
1594,14,52,66,8.096323112689252e-05,0.0002412444502178159,0.0001710899466510439
1595,32,16,48,0.00018505881400432574,7.422906160548182e-05,0.0001244290521098501
1596,25,35,60,0.0001445771984408795,0.00016237607226199147,0.00015553631513731263
1597,11,48,59,6.361396731398698e-05,0.00022268718481644544,0.00015294404321835743
1598,15,41,56,8.67463190645277e-05,0.00019021197036404714,0.0001451672274614918
1599,43,15,58,0.00024867278131831275,6.95897452551392e-05,0.00015035177129940223
1600,59,2,61,0.0003412021883204756,9.278632700685228e-06,0.00015812858705626786
1601,1,77,78,5.783087937635179e-06,0.00035722735897638123,0.00020219720967850643
1602,25,36,61,0.0001445771984408795,0.00016701538861233408,0.00015812858705626786
1603,20,38,58,0.0001156617587527036,0.00017629402131301932,0.00015035177129940223
1604,51,19,70,0.00029493748481939416,8.814701065650966e-05,0.00018145903432686475
1605,14,41,55,8.096323112689252e-05,0.00019021197036404714,0.00014257495554253658
1606,9,53,62,5.204779143871662e-05,0.0002458837665681585,0.00016072085897522306
1607,33,35,68,0.00019084190194196092,0.00016237607226199147,0.00017627449048895433
1608,17,42,59,9.831249493979805e-05,0.00019485128671438976,0.00015294404321835743
1609,11,49,60,6.361396731398698e-05,0.00022732650116678805,0.00015553631513731263
1610,1,63,64,5.783087937635179e-06,0.00029227693007158464,0.00016590540281313348
1611,20,42,62,0.0001156617587527036,0.00019485128671438976,0.00016072085897522306
1612,29,24,53,0.00016770955019142022,0.00011134359240822272,0.00013739041170462616
1613,5,51,56,2.89154396881759e-05,0.0002366051338674733,0.0001451672274614918
1614,77,9,86,0.00044529777119790885,4.175384715308352e-05,0.00022293538503014812
1615,57,14,71,0.00032963601244520525,6.495042890479659e-05,0.00018405130624581995
1616,58,14,72,0.00033541910038284044,6.495042890479659e-05,0.00018664357816477518
1617,16,34,50,9.252940700216287e-05,0.00015773675591164885,0.00012961359594776053
1618,27,23,50,0.00015614337431614985,0.00010670427605788011,0.00012961359594776053
1619,5,54,59,2.89154396881759e-05,0.0002505230829185011,0.00015294404321835743
1620,20,44,64,0.0001156617587527036,0.000204129919415075,0.00016590540281313348
1621,17,42,59,9.831249493979805e-05,0.00019485128671438976,0.00015294404321835743
1622,36,32,68,0.00020819116575486647,0.00014845812321096364,0.00017627449048895433
1623,1,65,66,5.783087937635179e-06,0.0003015555627722699,0.0001710899466510439
1624,1,21,22,5.783087937635179e-06,9.742564335719488e-05,5.702998221701464e-05
1625,29,32,61,0.00016770955019142022,0.00014845812321096364,0.00015812858705626786
1626,24,32,56,0.0001387941105032443,0.00014845812321096364,0.0001451672274614918
1627,42,16,58,0.00024288969338067754,7.422906160548182e-05,0.00015035177129940223
1628,41,26,67,0.00023710660544304236,0.00012062222510890795,0.00017368221856999913
1629,18,49,67,0.00010409558287743323,0.00022732650116678805,0.00017368221856999913
1630,27,27,54,0.00015614337431614985,0.00012526154145925056,0.00013998268362358138
1631,8,49,57,4.6264703501081435e-05,0.00022732650116678805,0.000147759499380447
1632,3,49,52,1.7349263812905538e-05,0.00022732650116678805,0.00013479813978567096
1633,57,7,64,0.00032963601244520525,3.247521445239829e-05,0.00016590540281313348
1634,5,50,55,2.89154396881759e-05,0.00023196581751713067,0.00014257495554253658
1635,8,39,47,4.6264703501081435e-05,0.00018093333766336194,0.0001218367801908949
1636,1,62,63,5.783087937635179e-06,0.00028763761372124205,0.00016331313089417828
1637,11,43,54,6.361396731398698e-05,0.00019949060306473238,0.00013998268362358138
1638,10,52,62,5.78308793763518e-05,0.0002412444502178159,0.00016072085897522306
1639,36,25,61,0.00020819116575486647,0.00011598290875856534,0.00015812858705626786
1640,11,50,61,6.361396731398698e-05,0.00023196581751713067,0.00015812858705626786
1641,29,33,62,0.00016770955019142022,0.00015309743956130623,0.00016072085897522306
1642,42,22,64,0.00024288969338067754,0.0001020649597075375,0.00016590540281313348
1643,9,43,52,5.204779143871662e-05,0.00019949060306473238,0.00013479813978567096
1644,61,9,70,0.000352768364195746,4.175384715308352e-05,0.00018145903432686475
1645,9,59,68,5.204779143871662e-05,0.00027371966467021417,0.00017627449048895433
1646,5,64,69,2.89154396881759e-05,0.0002969162464219273,0.00017886676240790953
1647,12,45,57,6.939705525162215e-05,0.0002087692357654176,0.000147759499380447
1648,37,26,63,0.00021397425369250165,0.00012062222510890795,0.00016331313089417828
1649,45,22,67,0.00026023895719358306,0.0001020649597075375,0.00017368221856999913
1650,9,46,55,5.204779143871662e-05,0.00021340855211576023,0.00014257495554253658
1651,37,5,42,0.00021397425369250165,2.319658175171307e-05,0.00010887542059611885
1652,34,15,49,0.0001966249898795961,6.95897452551392e-05,0.00012702132402880534
1653,14,20,34,8.096323112689252e-05,9.278632700685228e-05,8.813724524447716e-05
1654,7,32,39,4.048161556344626e-05,0.00014845812321096364,0.00010109860483925321
1655,5,64,69,2.89154396881759e-05,0.0002969162464219273,0.00017886676240790953
1656,14,46,60,8.096323112689252e-05,0.00021340855211576023,0.00015553631513731263
1657,11,64,75,6.361396731398698e-05,0.0002969162464219273,0.0001944203939216408
1658,51,12,63,0.00029493748481939416,5.567179620411136e-05,0.00016331313089417828
1659,27,34,61,0.00015614337431614985,0.00015773675591164885,0.00015812858705626786
1660,54,7,61,0.0003122867486322997,3.247521445239829e-05,0.00015812858705626786
1661,3,52,55,1.7349263812905538e-05,0.0002412444502178159,0.00014257495554253658
1662,19,46,65,0.00010987867081506842,0.00021340855211576023,0.0001684976747320887
1663,45,10,55,0.00026023895719358306,4.639316350342614e-05,0.00014257495554253658
1664,14,46,60,8.096323112689252e-05,0.00021340855211576023,0.00015553631513731263
1665,62,2,64,0.00035855145213338117,9.278632700685228e-06,0.00016590540281313348
1666,13,46,59,7.518014318925733e-05,0.00021340855211576023,0.00015294404321835743
1667,1,61,62,5.783087937635179e-06,0.0002829982973708994,0.00016072085897522306
1668,57,11,68,0.00032963601244520525,5.103247985376875e-05,0.00017627449048895433
1669,11,46,57,6.361396731398698e-05,0.00021340855211576023,0.000147759499380447
1670,24,37,61,0.0001387941105032443,0.0001716547049626767,0.00015812858705626786
1671,33,32,65,0.00019084190194196092,0.00014845812321096364,0.0001684976747320887
1672,24,33,57,0.0001387941105032443,0.00015309743956130623,0.000147759499380447
1673,17,41,58,9.831249493979805e-05,0.00019021197036404714,0.00015035177129940223
1674,45,11,56,0.00026023895719358306,5.103247985376875e-05,0.0001451672274614918
1675,63,7,70,0.0003643345400710163,3.247521445239829e-05,0.00018145903432686475
1676,48,19,67,0.0002775882210064886,8.814701065650966e-05,0.00017368221856999913
1677,22,41,63,0.00012722793462797397,0.00019021197036404714,0.00016331313089417828
1678,39,22,61,0.00022554042956777202,0.0001020649597075375,0.00015812858705626786
1679,26,30,56,0.00015036028637851467,0.0001391794905102784,0.0001451672274614918
1680,7,52,59,4.048161556344626e-05,0.0002412444502178159,0.00015294404321835743
1681,31,28,59,0.00017927572606669058,0.00012990085780959317,0.00015294404321835743
1682,2,40,42,1.1566175875270359e-05,0.00018557265401370455,0.00010887542059611885
1683,29,24,53,0.00016770955019142022,0.00011134359240822272,0.00013739041170462616
1684,35,21,56,0.0002024080778172313,9.742564335719488e-05,0.0001451672274614918
1685,16,46,62,9.252940700216287e-05,0.00021340855211576023,0.00016072085897522306
1686,27,34,61,0.00015614337431614985,0.00015773675591164885,0.00015812858705626786
1687,29,37,66,0.00016770955019142022,0.0001716547049626767,0.0001710899466510439
1688,20,45,65,0.0001156617587527036,0.0002087692357654176,0.0001684976747320887
1689,6,50,56,3.4698527625811076e-05,0.00023196581751713067,0.0001451672274614918
1690,50,14,64,0.000289154396881759,6.495042890479659e-05,0.00016590540281313348
1691,8,51,59,4.6264703501081435e-05,0.0002366051338674733,0.00015294404321835743
1692,44,14,58,0.00025445586925594793,6.495042890479659e-05,0.00015035177129940223
1693,28,25,53,0.00016192646225378504,0.00011598290875856534,0.00013739041170462616
1694,40,26,66,0.0002313235175054072,0.00012062222510890795,0.0001710899466510439
1695,1,55,56,5.783087937635179e-06,0.00025516239926884376,0.0001451672274614918
1696,36,23,59,0.00020819116575486647,0.00010670427605788011,0.00015294404321835743
1697,34,25,59,0.0001966249898795961,0.00011598290875856534,0.00015294404321835743
1698,41,22,63,0.00023710660544304236,0.0001020649597075375,0.00016331313089417828
1699,34,25,59,0.0001966249898795961,0.00011598290875856534,0.00015294404321835743
1700,7,60,67,4.048161556344626e-05,0.0002783589810205568,0.00017368221856999913
1701,30,34,64,0.0001734926381290554,0.00015773675591164885,0.00016590540281313348
1702,28,29,57,0.00016192646225378504,0.0001345401741599358,0.000147759499380447
1703,22,39,61,0.00012722793462797397,0.00018093333766336194,0.00015812858705626786
1704,9,49,58,5.204779143871662e-05,0.00022732650116678805,0.00015035177129940223
1705,42,14,56,0.00024288969338067754,6.495042890479659e-05,0.0001451672274614918
1706,35,36,71,0.0002024080778172313,0.00016701538861233408,0.00018405130624581995
1707,35,26,61,0.0002024080778172313,0.00012062222510890795,0.00015812858705626786
1708,22,38,60,0.00012722793462797397,0.00017629402131301932,0.00015553631513731263
1709,31,28,59,0.00017927572606669058,0.00012990085780959317,0.00015294404321835743
1710,4,65,69,2.3132351750540717e-05,0.0003015555627722699,0.00017886676240790953
1711,26,27,53,0.00015036028637851467,0.00012526154145925056,0.00013739041170462616
1712,21,35,56,0.00012144484669033877,0.00016237607226199147,0.0001451672274614918
1713,25,31,56,0.0001445771984408795,0.00014381880686062103,0.0001451672274614918
1714,72,5,77,0.00041638233150973294,2.319658175171307e-05,0.00019960493775955123
1715,40,20,60,0.0002313235175054072,9.278632700685228e-05,0.00015553631513731263
1716,10,47,57,5.78308793763518e-05,0.00021804786846610285,0.000147759499380447
1717,10,48,58,5.78308793763518e-05,0.00022268718481644544,0.00015035177129940223
1718,11,39,50,6.361396731398698e-05,0.00018093333766336194,0.00012961359594776053
1719,41,8,49,0.00023710660544304236,3.711453080274091e-05,0.00012702132402880534
1720,2,57,59,1.1566175875270359e-05,0.000264441031969529,0.00015294404321835743
1721,65,5,70,0.00037590071594628666,2.319658175171307e-05,0.00018145903432686475
1722,39,23,62,0.00022554042956777202,0.00010670427605788011,0.00016072085897522306
1723,35,24,59,0.0002024080778172313,0.00011134359240822272,0.00015294404321835743
1724,22,32,54,0.00012722793462797397,0.00014845812321096364,0.00013998268362358138
1725,20,48,68,0.0001156617587527036,0.00022268718481644544,0.00017627449048895433
1726,47,17,64,0.0002718051330688534,7.886837795582442e-05,0.00016590540281313348
1727,32,28,60,0.00018505881400432574,0.00012990085780959317,0.00015553631513731263
1728,39,21,60,0.00022554042956777202,9.742564335719488e-05,0.00015553631513731263
1729,12,45,57,6.939705525162215e-05,0.0002087692357654176,0.000147759499380447
1730,8,43,51,4.6264703501081435e-05,0.00019949060306473238,0.00013220586786671573
1731,27,34,61,0.00015614337431614985,0.00015773675591164885,0.00015812858705626786
1732,27,26,53,0.00015614337431614985,0.00012062222510890795,0.00013739041170462616
1733,50,14,64,0.000289154396881759,6.495042890479659e-05,0.00016590540281313348
1734,20,40,60,0.0001156617587527036,0.00018557265401370455,0.00015553631513731263
1735,60,5,65,0.0003469852762581108,2.319658175171307e-05,0.0001684976747320887
1736,32,16,48,0.00018505881400432574,7.422906160548182e-05,0.0001244290521098501
1737,44,2,46,0.00025445586925594793,9.278632700685228e-06,0.0001192445082719397
1738,42,13,55,0.00024288969338067754,6.0311112554453976e-05,0.00014257495554253658
1739,31,31,62,0.00017927572606669058,0.00014381880686062103,0.00016072085897522306
1740,10,55,65,5.78308793763518e-05,0.00025516239926884376,0.0001684976747320887
1741,1,52,53,5.783087937635179e-06,0.0002412444502178159,0.00013739041170462616
1742,7,54,61,4.048161556344626e-05,0.0002505230829185011,0.00015812858705626786
1743,12,38,50,6.939705525162215e-05,0.00017629402131301932,0.00012961359594776053
1744,3,57,60,1.7349263812905538e-05,0.000264441031969529,0.00015553631513731263
1745,51,4,55,0.00029493748481939416,1.8557265401370455e-05,0.00014257495554253658
1746,33,26,59,0.00019084190194196092,0.00012062222510890795,0.00015294404321835743
1747,32,29,61,0.00018505881400432574,0.0001345401741599358,0.00015812858705626786
1748,28,26,54,0.00016192646225378504,0.00012062222510890795,0.00013998268362358138
1749,20,36,56,0.0001156617587527036,0.00016701538861233408,0.0001451672274614918
1750,57,8,65,0.00032963601244520525,3.711453080274091e-05,0.0001684976747320887
1751,32,21,53,0.00018505881400432574,9.742564335719488e-05,0.00013739041170462616
1752,30,26,56,0.0001734926381290554,0.00012062222510890795,0.0001451672274614918
1753,43,10,53,0.00024867278131831275,4.639316350342614e-05,0.00013739041170462616
1754,16,36,52,9.252940700216287e-05,0.00016701538861233408,0.00013479813978567096
1755,2,50,52,1.1566175875270359e-05,0.00023196581751713067,0.00013479813978567096
1756,42,16,58,0.00024288969338067754,7.422906160548182e-05,0.00015035177129940223
1757,13,44,57,7.518014318925733e-05,0.000204129919415075,0.000147759499380447
1758,17,42,59,9.831249493979805e-05,0.00019485128671438976,0.00015294404321835743
1759,48,9,57,0.0002775882210064886,4.175384715308352e-05,0.000147759499380447
1760,36,17,53,0.00020819116575486647,7.886837795582442e-05,0.00013739041170462616
1761,19,39,58,0.00010987867081506842,0.00018093333766336194,0.00015035177129940223
1762,31,17,48,0.00017927572606669058,7.886837795582442e-05,0.0001244290521098501
1763,20,42,62,0.0001156617587527036,0.00019485128671438976,0.00016072085897522306
1764,18,55,73,0.00010409558287743323,0.00025516239926884376,0.00018923585008373038
1765,10,46,56,5.78308793763518e-05,0.00021340855211576023,0.0001451672274614918
1766,20,28,48,0.0001156617587527036,0.00012990085780959317,0.0001244290521098501
1767,11,49,60,6.361396731398698e-05,0.00022732650116678805,0.00015553631513731263
1768,1,40,41,5.783087937635179e-06,0.00018557265401370455,0.00010628314867716364
1769,58,5,63,0.00033541910038284044,2.319658175171307e-05,0.00016331313089417828
1770,4,51,55,2.3132351750540717e-05,0.0002366051338674733,0.00014257495554253658
1771,9,39,48,5.204779143871662e-05,0.00018093333766336194,0.0001244290521098501
1772,23,30,53,0.00013301102256560912,0.0001391794905102784,0.00013739041170462616
1773,40,26,66,0.0002313235175054072,0.00012062222510890795,0.0001710899466510439
1774,27,25,52,0.00015614337431614985,0.00011598290875856534,0.00013479813978567096
1775,30,29,59,0.0001734926381290554,0.0001345401741599358,0.00015294404321835743
1776,5,53,58,2.89154396881759e-05,0.0002458837665681585,0.00015035177129940223
1777,26,21,47,0.00015036028637851467,9.742564335719488e-05,0.0001218367801908949
1778,21,28,49,0.00012144484669033877,0.00012990085780959317,0.00012702132402880534
1779,5,45,50,2.89154396881759e-05,0.0002087692357654176,0.00012961359594776053
1780,37,17,54,0.00021397425369250165,7.886837795582442e-05,0.00013998268362358138
1781,56,6,62,0.00032385292450757007,2.783589810205568e-05,0.00016072085897522306
1782,3,41,44,1.7349263812905538e-05,0.00019021197036404714,0.00011405996443402927
1783,43,19,62,0.00024867278131831275,8.814701065650966e-05,0.00016072085897522306
1784,7,48,55,4.048161556344626e-05,0.00022268718481644544,0.00014257495554253658
1785,1,62,63,5.783087937635179e-06,0.00028763761372124205,0.00016331313089417828
1786,19,16,35,0.00010987867081506842,7.422906160548182e-05,9.072951716343238e-05
1787,32,21,53,0.00018505881400432574,9.742564335719488e-05,0.00013739041170462616
1788,36,23,59,0.00020819116575486647,0.00010670427605788011,0.00015294404321835743
1789,30,20,50,0.0001734926381290554,9.278632700685228e-05,0.00012961359594776053
1790,54,4,58,0.0003122867486322997,1.8557265401370455e-05,0.00015035177129940223
1791,66,1,67,0.00038168380388392184,4.639316350342614e-06,0.00017368221856999913
1792,44,15,59,0.00025445586925594793,6.95897452551392e-05,0.00015294404321835743
1793,11,39,50,6.361396731398698e-05,0.00018093333766336194,0.00012961359594776053
1794,14,34,48,8.096323112689252e-05,0.00015773675591164885,0.0001244290521098501
1795,20,33,53,0.0001156617587527036,0.00015309743956130623,0.00013739041170462616
1796,6,50,56,3.4698527625811076e-05,0.00023196581751713067,0.0001451672274614918
1797,9,47,56,5.204779143871662e-05,0.00021804786846610285,0.0001451672274614918
1798,38,19,57,0.00021975734163013684,8.814701065650966e-05,0.000147759499380447
1799,22,5,27,0.00012722793462797397,2.319658175171307e-05,6.999134181179069e-05
1800,49,12,61,0.0002833713089441238,5.567179620411136e-05,0.00015812858705626786
1801,1,60,61,5.783087937635179e-06,0.0002783589810205568,0.00015812858705626786
1802,23,34,57,0.00013301102256560912,0.00015773675591164885,0.000147759499380447
1803,10,42,52,5.78308793763518e-05,0.00019485128671438976,0.00013479813978567096
1804,9,42,51,5.204779143871662e-05,0.00019485128671438976,0.00013220586786671573
1805,17,34,51,9.831249493979805e-05,0.00015773675591164885,0.00013220586786671573
1806,34,24,58,0.0001966249898795961,0.00011134359240822272,0.00015035177129940223
1807,59,2,61,0.0003412021883204756,9.278632700685228e-06,0.00015812858705626786
1808,3,54,57,1.7349263812905538e-05,0.0002505230829185011,0.000147759499380447
1809,1,58,59,5.783087937635179e-06,0.0002690803483198716,0.00015294404321835743
1810,10,32,42,5.78308793763518e-05,0.00014845812321096364,0.00010887542059611885
1811,44,10,54,0.00025445586925594793,4.639316350342614e-05,0.00013998268362358138
1812,67,3,70,0.000387466891821557,1.391794905102784e-05,0.00018145903432686475
1813,23,35,58,0.00013301102256560912,0.00016237607226199147,0.00015035177129940223
1814,46,13,59,0.00026602204513121824,6.0311112554453976e-05,0.00015294404321835743
1815,1,49,50,5.783087937635179e-06,0.00022732650116678805,0.00012961359594776053
1816,32,28,60,0.00018505881400432574,0.00012990085780959317,0.00015553631513731263
1817,4,49,53,2.3132351750540717e-05,0.00022732650116678805,0.00013739041170462616
1818,53,5,58,0.0003065036606946645,2.319658175171307e-05,0.00015035177129940223
1819,16,34,50,9.252940700216287e-05,0.00015773675591164885,0.00012961359594776053
1820,17,42,59,9.831249493979805e-05,0.00019485128671438976,0.00015294404321835743
1821,7,45,52,4.048161556344626e-05,0.0002087692357654176,0.00013479813978567096
1822,15,41,56,8.67463190645277e-05,0.00019021197036404714,0.0001451672274614918
1823,3,45,48,1.7349263812905538e-05,0.0002087692357654176,0.0001244290521098501
1824,17,40,57,9.831249493979805e-05,0.00018557265401370455,0.000147759499380447
1825,50,7,57,0.000289154396881759,3.247521445239829e-05,0.000147759499380447
1826,16,29,45,9.252940700216287e-05,0.0001345401741599358,0.00011665223635298449
1827,17,31,48,9.831249493979805e-05,0.00014381880686062103,0.0001244290521098501
1828,36,23,59,0.00020819116575486647,0.00010670427605788011,0.00015294404321835743
1829,10,43,53,5.78308793763518e-05,0.00019949060306473238,0.00013739041170462616
1830,15,34,49,8.67463190645277e-05,0.00015773675591164885,0.00012702132402880534
1831,13,43,56,7.518014318925733e-05,0.00019949060306473238,0.0001451672274614918
1832,1,38,39,5.783087937635179e-06,0.00017629402131301932,0.00010109860483925321
1833,1,47,48,5.783087937635179e-06,0.00021804786846610285,0.0001244290521098501
1834,19,33,52,0.00010987867081506842,0.00015309743956130623,0.00013479813978567096
1835,43,3,46,0.00024867278131831275,1.391794905102784e-05,0.0001192445082719397
1836,1,39,40,5.783087937635179e-06,0.00018093333766336194,0.00010369087675820843
1837,24,34,58,0.0001387941105032443,0.00015773675591164885,0.00015035177129940223
1838,17,34,51,9.831249493979805e-05,0.00015773675591164885,0.00013220586786671573
1839,31,25,56,0.00017927572606669058,0.00011598290875856534,0.0001451672274614918
1840,47,7,54,0.0002718051330688534,3.247521445239829e-05,0.00013998268362358138
1841,8,53,61,4.6264703501081435e-05,0.0002458837665681585,0.00015812858705626786
1842,27,30,57,0.00015614337431614985,0.0001391794905102784,0.000147759499380447
1843,4,45,49,2.3132351750540717e-05,0.0002087692357654176,0.00012702132402880534
1844,62,1,63,0.00035855145213338117,4.639316350342614e-06,0.00016331313089417828
1845,20,37,57,0.0001156617587527036,0.0001716547049626767,0.000147759499380447
1846,50,5,55,0.000289154396881759,2.319658175171307e-05,0.00014257495554253658
1847,10,34,44,5.78308793763518e-05,0.00015773675591164885,0.00011405996443402927
1848,32,17,49,0.00018505881400432574,7.886837795582442e-05,0.00012702132402880534
1849,1,53,54,5.783087937635179e-06,0.0002458837665681585,0.00013998268362358138
1850,38,17,55,0.00021975734163013684,7.886837795582442e-05,0.00014257495554253658
1851,15,39,54,8.67463190645277e-05,0.00018093333766336194,0.00013998268362358138
1852,39,11,50,0.00022554042956777202,5.103247985376875e-05,0.00012961359594776053
1853,55,5,60,0.0003180698365699349,2.319658175171307e-05,0.00015553631513731263
1854,20,37,57,0.0001156617587527036,0.0001716547049626767,0.000147759499380447
1855,68,1,69,0.0003932499797591922,4.639316350342614e-06,0.00017886676240790953
1856,17,35,52,9.831249493979805e-05,0.00016237607226199147,0.00013479813978567096
1857,11,42,53,6.361396731398698e-05,0.00019485128671438976,0.00013739041170462616
1858,20,36,56,0.0001156617587527036,0.00016701538861233408,0.0001451672274614918
1859,15,38,53,8.67463190645277e-05,0.00017629402131301932,0.00013739041170462616
1860,1,42,43,5.783087937635179e-06,0.00019485128671438976,0.00011146769251507406
1861,28,24,52,0.00016192646225378504,0.00011134359240822272,0.00013479813978567096
1862,15,33,48,8.67463190645277e-05,0.00015309743956130623,0.0001244290521098501
1863,26,22,48,0.00015036028637851467,0.0001020649597075375,0.0001244290521098501
1864,13,43,56,7.518014318925733e-05,0.00019949060306473238,0.0001451672274614918
1865,38,15,53,0.00021975734163013684,6.95897452551392e-05,0.00013739041170462616
1866,50,6,56,0.000289154396881759,2.783589810205568e-05,0.0001451672274614918
1867,12,47,59,6.939705525162215e-05,0.00021804786846610285,0.00015294404321835743
1868,28,29,57,0.00016192646225378504,0.0001345401741599358,0.000147759499380447
1869,17,41,58,9.831249493979805e-05,0.00019021197036404714,0.00015035177129940223
1870,24,31,55,0.0001387941105032443,0.00014381880686062103,0.00014257495554253658
1871,44,22,66,0.00025445586925594793,0.0001020649597075375,0.0001710899466510439
1872,8,49,57,4.6264703501081435e-05,0.00022732650116678805,0.000147759499380447
1873,13,41,54,7.518014318925733e-05,0.00019021197036404714,0.00013998268362358138
1874,5,45,50,2.89154396881759e-05,0.0002087692357654176,0.00012961359594776053
1875,19,42,61,0.00010987867081506842,0.00019485128671438976,0.00015812858705626786
1876,17,34,51,9.831249493979805e-05,0.00015773675591164885,0.00013220586786671573
1877,9,38,47,5.204779143871662e-05,0.00017629402131301932,0.0001218367801908949
1878,27,21,48,0.00015614337431614985,9.742564335719488e-05,0.0001244290521098501
1879,31,20,51,0.00017927572606669058,9.278632700685228e-05,0.00013220586786671573
1880,26,27,53,0.00015036028637851467,0.00012526154145925056,0.00013739041170462616
1881,44,15,59,0.00025445586925594793,6.95897452551392e-05,0.00015294404321835743
1882,1,56,57,5.783087937635179e-06,0.00025980171561918635,0.000147759499380447
1883,18,40,58,0.00010409558287743323,0.00018557265401370455,0.00015035177129940223
1884,14,46,60,8.096323112689252e-05,0.00021340855211576023,0.00015553631513731263
1885,73,1,74,0.0004221654194473681,4.639316350342614e-06,0.0001918281220026856
1886,50,11,61,0.000289154396881759,5.103247985376875e-05,0.00015812858705626786
1887,28,23,51,0.00016192646225378504,0.00010670427605788011,0.00013220586786671573
1888,22,30,52,0.00012722793462797397,0.0001391794905102784,0.00013479813978567096
1889,11,43,54,6.361396731398698e-05,0.00019949060306473238,0.00013998268362358138
1890,51,6,57,0.00029493748481939416,2.783589810205568e-05,0.000147759499380447
1891,18,40,58,0.00010409558287743323,0.00018557265401370455,0.00015035177129940223
1892,18,31,49,0.00010409558287743323,0.00014381880686062103,0.00012702132402880534
1893,40,5,45,0.0002313235175054072,2.319658175171307e-05,0.00011665223635298449
1894,8,39,47,4.6264703501081435e-05,0.00018093333766336194,0.0001218367801908949
1895,37,5,42,0.00021397425369250165,2.319658175171307e-05,0.00010887542059611885
1896,43,5,48,0.00024867278131831275,2.319658175171307e-05,0.0001244290521098501
1897,34,12,46,0.0001966249898795961,5.567179620411136e-05,0.0001192445082719397
1898,27,30,57,0.00015614337431614985,0.0001391794905102784,0.000147759499380447
1899,30,18,48,0.0001734926381290554,8.350769430616704e-05,0.0001244290521098501
1900,29,24,53,0.00016770955019142022,0.00011134359240822272,0.00013739041170462616
1901,50,15,65,0.000289154396881759,6.95897452551392e-05,0.0001684976747320887
1902,17,32,49,9.831249493979805e-05,0.00014845812321096364,0.00012702132402880534
1903,19,24,43,0.00010987867081506842,0.00011134359240822272,0.00011146769251507406
1904,32,12,44,0.00018505881400432574,5.567179620411136e-05,0.00011405996443402927
1905,9,45,54,5.204779143871662e-05,0.0002087692357654176,0.00013998268362358138
1906,35,3,38,0.0002024080778172313,1.391794905102784e-05,9.850633292029801e-05
1907,17,31,48,9.831249493979805e-05,0.00014381880686062103,0.0001244290521098501
1908,52,14,66,0.00030072057275702934,6.495042890479659e-05,0.0001710899466510439
1909,1,48,49,5.783087937635179e-06,0.00022268718481644544,0.00012702132402880534
1910,8,43,51,4.6264703501081435e-05,0.00019949060306473238,0.00013220586786671573
1911,17,38,55,9.831249493979805e-05,0.00017629402131301932,0.00014257495554253658
1912,64,2,66,0.0003701176280086515,9.278632700685228e-06,0.0001710899466510439
1913,19,43,62,0.00010987867081506842,0.00019949060306473238,0.00016072085897522306
1914,36,18,54,0.00020819116575486647,8.350769430616704e-05,0.00013998268362358138
1915,45,9,54,0.00026023895719358306,4.175384715308352e-05,0.00013998268362358138
1916,22,36,58,0.00012722793462797397,0.00016701538861233408,0.00015035177129940223
1917,52,7,59,0.00030072057275702934,3.247521445239829e-05,0.00015294404321835743
1918,2,45,47,1.1566175875270359e-05,0.0002087692357654176,0.0001218367801908949
1919,23,23,46,0.00013301102256560912,0.00010670427605788011,0.0001192445082719397
1920,23,28,51,0.00013301102256560912,0.00012990085780959317,0.00013220586786671573
1921,44,18,62,0.00025445586925594793,8.350769430616704e-05,0.00016072085897522306
1922,25,22,47,0.0001445771984408795,0.0001020649597075375,0.0001218367801908949
1923,3,37,40,1.7349263812905538e-05,0.0001716547049626767,0.00010369087675820843
1924,11,38,49,6.361396731398698e-05,0.00017629402131301932,0.00012702132402880534
1925,36,18,54,0.00020819116575486647,8.350769430616704e-05,0.00013998268362358138
1926,53,5,58,0.0003065036606946645,2.319658175171307e-05,0.00015035177129940223
1927,9,39,48,5.204779143871662e-05,0.00018093333766336194,0.0001244290521098501
1928,28,29,57,0.00016192646225378504,0.0001345401741599358,0.000147759499380447
1929,2,61,63,1.1566175875270359e-05,0.0002829982973708994,0.00016331313089417828
1930,14,38,52,8.096323112689252e-05,0.00017629402131301932,0.00013479813978567096
1931,19,31,50,0.00010987867081506842,0.00014381880686062103,0.00012961359594776053
1932,27,29,56,0.00015614337431614985,0.0001345401741599358,0.0001451672274614918
1933,3,51,54,1.7349263812905538e-05,0.0002366051338674733,0.00013998268362358138
1934,7,50,57,4.048161556344626e-05,0.00023196581751713067,0.000147759499380447
1935,1,39,40,5.783087937635179e-06,0.00018093333766336194,0.00010369087675820843
1936,29,10,39,0.00016770955019142022,4.639316350342614e-05,0.00010109860483925321
1937,44,6,50,0.00025445586925594793,2.783589810205568e-05,0.00012961359594776053
1938,3,39,42,1.7349263812905538e-05,0.00018093333766336194,0.00010887542059611885
1939,21,22,43,0.00012144484669033877,0.0001020649597075375,0.00011146769251507406
1940,39,2,41,0.00022554042956777202,9.278632700685228e-06,0.00010628314867716364
1941,1,51,52,5.783087937635179e-06,0.0002366051338674733,0.00013479813978567096
1942,1,48,49,5.783087937635179e-06,0.00022268718481644544,0.00012702132402880534
1943,18,34,52,0.00010409558287743323,0.00015773675591164885,0.00013479813978567096
1944,19,28,47,0.00010987867081506842,0.00012990085780959317,0.0001218367801908949
1945,34,15,49,0.0001966249898795961,6.95897452551392e-05,0.00012702132402880534
1946,6,43,49,3.4698527625811076e-05,0.00019949060306473238,0.00012702132402880534
1947,38,13,51,0.00021975734163013684,6.0311112554453976e-05,0.00013220586786671573
1948,34,10,44,0.0001966249898795961,4.639316350342614e-05,0.00011405996443402927
1949,25,33,58,0.0001445771984408795,0.00015309743956130623,0.00015035177129940223
1950,5,40,45,2.89154396881759e-05,0.00018557265401370455,0.00011665223635298449
1951,10,40,50,5.78308793763518e-05,0.00018557265401370455,0.00012961359594776053
1952,20,28,48,0.0001156617587527036,0.00012990085780959317,0.0001244290521098501
1953,29,22,51,0.00016770955019142022,0.0001020649597075375,0.00013220586786671573
1954,1,34,35,5.783087937635179e-06,0.00015773675591164885,9.072951716343238e-05
1955,5,48,53,2.89154396881759e-05,0.00022268718481644544,0.00013739041170462616
1956,38,21,59,0.00021975734163013684,9.742564335719488e-05,0.00015294404321835743
1957,3,42,45,1.7349263812905538e-05,0.00019485128671438976,0.00011665223635298449
1958,33,30,63,0.00019084190194196092,0.0001391794905102784,0.00016331313089417828
1959,42,11,53,0.00024288969338067754,5.103247985376875e-05,0.00013739041170462616
1960,19,23,42,0.00010987867081506842,0.00010670427605788011,0.00010887542059611885
1961,21,39,60,0.00012144484669033877,0.00018093333766336194,0.00015553631513731263
1962,1,51,52,5.783087937635179e-06,0.0002366051338674733,0.00013479813978567096
1963,7,44,51,4.048161556344626e-05,0.000204129919415075,0.00013220586786671573
1964,34,19,53,0.0001966249898795961,8.814701065650966e-05,0.00013739041170462616
1965,54,9,63,0.0003122867486322997,4.175384715308352e-05,0.00016331313089417828
1966,1,51,52,5.783087937635179e-06,0.0002366051338674733,0.00013479813978567096
1967,44,19,63,0.00025445586925594793,8.814701065650966e-05,0.00016331313089417828
1968,40,14,54,0.0002313235175054072,6.495042890479659e-05,0.00013998268362358138
1969,49,7,56,0.0002833713089441238,3.247521445239829e-05,0.0001451672274614918
1970,1,51,52,5.783087937635179e-06,0.0002366051338674733,0.00013479813978567096
1971,12,41,53,6.939705525162215e-05,0.00019021197036404714,0.00013739041170462616
1972,4,48,52,2.3132351750540717e-05,0.00022268718481644544,0.00013479813978567096
1973,44,12,56,0.00025445586925594793,5.567179620411136e-05,0.0001451672274614918
1974,14,38,52,8.096323112689252e-05,0.00017629402131301932,0.00013479813978567096
1975,26,32,58,0.00015036028637851467,0.00014845812321096364,0.00015035177129940223
1976,2,61,63,1.1566175875270359e-05,0.0002829982973708994,0.00016331313089417828
1977,1,55,56,5.783087937635179e-06,0.00025516239926884376,0.0001451672274614918
1978,38,2,40,0.00021975734163013684,9.278632700685228e-06,0.00010369087675820843
1979,58,5,63,0.00033541910038284044,2.319658175171307e-05,0.00016331313089417828
1980,27,20,47,0.00015614337431614985,9.278632700685228e-05,0.0001218367801908949
1981,6,52,58,3.4698527625811076e-05,0.0002412444502178159,0.00015035177129940223
1982,5,47,52,2.89154396881759e-05,0.00021804786846610285,0.00013479813978567096
1983,3,34,37,1.7349263812905538e-05,0.00015773675591164885,9.59140610013428e-05
1984,63,1,64,0.0003643345400710163,4.639316350342614e-06,0.00016590540281313348
1985,8,30,38,4.6264703501081435e-05,0.0001391794905102784,9.850633292029801e-05
1986,18,34,52,0.00010409558287743323,0.00015773675591164885,0.00013479813978567096
1987,42,8,50,0.00024288969338067754,3.711453080274091e-05,0.00012961359594776053
1988,17,37,54,9.831249493979805e-05,0.0001716547049626767,0.00013998268362358138
1989,25,28,53,0.0001445771984408795,0.00012990085780959317,0.00013739041170462616
1990,19,27,46,0.00010987867081506842,0.00012526154145925056,0.0001192445082719397
1991,56,3,59,0.00032385292450757007,1.391794905102784e-05,0.00015294404321835743
1992,24,24,48,0.0001387941105032443,0.00011134359240822272,0.0001244290521098501
1993,29,17,46,0.00016770955019142022,7.886837795582442e-05,0.0001192445082719397
1994,2,56,58,1.1566175875270359e-05,0.00025980171561918635,0.00015035177129940223
1995,13,41,54,7.518014318925733e-05,0.00019021197036404714,0.00013998268362358138
1996,6,31,37,3.4698527625811076e-05,0.00014381880686062103,9.59140610013428e-05
1997,32,18,50,0.00018505881400432574,8.350769430616704e-05,0.00012961359594776053
1998,4,53,57,2.3132351750540717e-05,0.0002458837665681585,0.000147759499380447
1999,1,46,47,5.783087937635179e-06,0.00021340855211576023,0.0001218367801908949
2000,10,40,50,5.78308793763518e-05,0.00018557265401370455,0.00012961359594776053
2001,1,50,51,5.783087937635179e-06,0.00023196581751713067,0.00013220586786671573
2002,19,32,51,0.00010987867081506842,0.00014845812321096364,0.00013220586786671573
2003,13,38,51,7.518014318925733e-05,0.00017629402131301932,0.00013220586786671573
2004,31,10,41,0.00017927572606669058,4.639316350342614e-05,0.00010628314867716364
2005,44,10,54,0.00025445586925594793,4.639316350342614e-05,0.00013998268362358138
2006,2,46,48,1.1566175875270359e-05,0.00021340855211576023,0.0001244290521098501
2007,25,26,51,0.0001445771984408795,0.00012062222510890795,0.00013220586786671573
2008,14,35,49,8.096323112689252e-05,0.00016237607226199147,0.00012702132402880534
2009,1,53,54,5.783087937635179e-06,0.0002458837665681585,0.00013998268362358138
2010,13,35,48,7.518014318925733e-05,0.00016237607226199147,0.0001244290521098501
2011,20,25,45,0.0001156617587527036,0.00011598290875856534,0.00011665223635298449
2012,14,36,50,8.096323112689252e-05,0.00016701538861233408,0.00012961359594776053
2013,1,52,53,5.783087937635179e-06,0.0002412444502178159,0.00013739041170462616
2014,52,2,54,0.00030072057275702934,9.278632700685228e-06,0.00013998268362358138
2015,12,35,47,6.939705525162215e-05,0.00016237607226199147,0.0001218367801908949
2016,40,4,44,0.0002313235175054072,1.8557265401370455e-05,0.00011405996443402927
2017,20,30,50,0.0001156617587527036,0.0001391794905102784,0.00012961359594776053
2018,6,43,49,3.4698527625811076e-05,0.00019949060306473238,0.00012702132402880534
2019,36,10,46,0.00020819116575486647,4.639316350342614e-05,0.0001192445082719397
2020,2,46,48,1.1566175875270359e-05,0.00021340855211576023,0.0001244290521098501
2021,1,48,49,5.783087937635179e-06,0.00022268718481644544,0.00012702132402880534
2022,24,17,41,0.0001387941105032443,7.886837795582442e-05,0.00010628314867716364
2023,44,5,49,0.00025445586925594793,2.319658175171307e-05,0.00012702132402880534
2024,7,37,44,4.048161556344626e-05,0.0001716547049626767,0.00011405996443402927
2025,23,24,47,0.00013301102256560912,0.00011134359240822272,0.0001218367801908949
2026,8,46,54,4.6264703501081435e-05,0.00021340855211576023,0.00013998268362358138
2027,1,41,42,5.783087937635179e-06,0.00019021197036404714,0.00010887542059611885
2028,26,21,47,0.00015036028637851467,9.742564335719488e-05,0.0001218367801908949
2029,1,47,48,5.783087937635179e-06,0.00021804786846610285,0.0001244290521098501
2030,23,27,50,0.00013301102256560912,0.00012526154145925056,0.00012961359594776053
2031,11,36,47,6.361396731398698e-05,0.00016701538861233408,0.0001218367801908949
2032,5,33,38,2.89154396881759e-05,0.00015309743956130623,9.850633292029801e-05
2033,25,26,51,0.0001445771984408795,0.00012062222510890795,0.00013220586786671573
2034,7,48,55,4.048161556344626e-05,0.00022268718481644544,0.00014257495554253658
2035,10,32,42,5.78308793763518e-05,0.00014845812321096364,0.00010887542059611885
2036,20,32,52,0.0001156617587527036,0.00014845812321096364,0.00013479813978567096
2037,11,40,51,6.361396731398698e-05,0.00018557265401370455,0.00013220586786671573
2038,27,25,52,0.00015614337431614985,0.00011598290875856534,0.00013479813978567096
2039,37,15,52,0.00021397425369250165,6.95897452551392e-05,0.00013479813978567096
2040,11,21,32,6.361396731398698e-05,9.742564335719488e-05,8.295270140656674e-05
2041,8,35,43,4.6264703501081435e-05,0.00016237607226199147,0.00011146769251507406
2042,1,43,44,5.783087937635179e-06,0.00019949060306473238,0.00011405996443402927
2043,33,17,50,0.00019084190194196092,7.886837795582442e-05,0.00012961359594776053
2044,10,43,53,5.78308793763518e-05,0.00019949060306473238,0.00013739041170462616
2045,29,23,52,0.00016770955019142022,0.00010670427605788011,0.00013479813978567096
2046,1,55,56,5.783087937635179e-06,0.00025516239926884376,0.0001451672274614918
2047,61,1,62,0.000352768364195746,4.639316350342614e-06,0.00016072085897522306
2048,26,29,55,0.00015036028637851467,0.0001345401741599358,0.00014257495554253658
2049,1,53,54,5.783087937635179e-06,0.0002458837665681585,0.00013998268362358138
2050,58,1,59,0.00033541910038284044,4.639316350342614e-06,0.00015294404321835743
2051,9,40,49,5.204779143871662e-05,0.00018557265401370455,0.00012702132402880534
2052,1,45,46,5.783087937635179e-06,0.0002087692357654176,0.0001192445082719397
2053,34,20,54,0.0001966249898795961,9.278632700685228e-05,0.00013998268362358138
2054,36,12,48,0.00020819116575486647,5.567179620411136e-05,0.0001244290521098501
2055,7,42,49,4.048161556344626e-05,0.00019485128671438976,0.00012702132402880534
2056,7,36,43,4.048161556344626e-05,0.00016701538861233408,0.00011146769251507406
2057,1,53,54,5.783087937635179e-06,0.0002458837665681585,0.00013998268362358138
2058,24,19,43,0.0001387941105032443,8.814701065650966e-05,0.00011146769251507406
2059,6,45,51,3.4698527625811076e-05,0.0002087692357654176,0.00013220586786671573
2060,39,16,55,0.00022554042956777202,7.422906160548182e-05,0.00014257495554253658
2061,34,12,46,0.0001966249898795961,5.567179620411136e-05,0.0001192445082719397
2062,18,27,45,0.00010409558287743323,0.00012526154145925056,0.00011665223635298449
2063,34,16,50,0.0001966249898795961,7.422906160548182e-05,0.00012961359594776053
2064,13,9,22,7.518014318925733e-05,4.175384715308352e-05,5.702998221701464e-05
2065,8,38,46,4.6264703501081435e-05,0.00017629402131301932,0.0001192445082719397
2066,3,42,45,1.7349263812905538e-05,0.00019485128671438976,0.00011665223635298449
2067,17,28,45,9.831249493979805e-05,0.00012990085780959317,0.00011665223635298449
2068,22,21,43,0.00012722793462797397,9.742564335719488e-05,0.00011146769251507406
2069,1,42,43,5.783087937635179e-06,0.00019485128671438976,0.00011146769251507406
2070,5,41,46,2.89154396881759e-05,0.00019021197036404714,0.0001192445082719397
2071,58,4,62,0.00033541910038284044,1.8557265401370455e-05,0.00016072085897522306
2072,7,36,43,4.048161556344626e-05,0.00016701538861233408,0.00011146769251507406
2073,19,29,48,0.00010987867081506842,0.0001345401741599358,0.0001244290521098501
2074,20,19,39,0.0001156617587527036,8.814701065650966e-05,0.00010109860483925321
2075,30,14,44,0.0001734926381290554,6.495042890479659e-05,0.00011405996443402927
2076,28,24,52,0.00016192646225378504,0.00011134359240822272,0.00013479813978567096
2077,17,43,60,9.831249493979805e-05,0.00019949060306473238,0.00015553631513731263
2078,20,26,46,0.0001156617587527036,0.00012062222510890795,0.0001192445082719397
2079,25,20,45,0.0001445771984408795,9.278632700685228e-05,0.00011665223635298449
2080,15,35,50,8.67463190645277e-05,0.00016237607226199147,0.00012961359594776053
2081,1,49,50,5.783087937635179e-06,0.00022732650116678805,0.00012961359594776053
2082,1,46,47,5.783087937635179e-06,0.00021340855211576023,0.0001218367801908949
2083,33,20,53,0.00019084190194196092,9.278632700685228e-05,0.00013739041170462616
2084,34,19,53,0.0001966249898795961,8.814701065650966e-05,0.00013739041170462616
2085,21,25,46,0.00012144484669033877,0.00011598290875856534,0.0001192445082719397
2086,23,21,44,0.00013301102256560912,9.742564335719488e-05,0.00011405996443402927
2087,13,33,46,7.518014318925733e-05,0.00015309743956130623,0.0001192445082719397
2088,38,14,52,0.00021975734163013684,6.495042890479659e-05,0.00013479813978567096
2089,17,26,43,9.831249493979805e-05,0.00012062222510890795,0.00011146769251507406
2090,14,35,49,8.096323112689252e-05,0.00016237607226199147,0.00012702132402880534
2091,10,38,48,5.78308793763518e-05,0.00017629402131301932,0.0001244290521098501
2092,15,23,38,8.67463190645277e-05,0.00010670427605788011,9.850633292029801e-05
2093,11,40,51,6.361396731398698e-05,0.00018557265401370455,0.00013220586786671573
2094,6,33,39,3.4698527625811076e-05,0.00015309743956130623,0.00010109860483925321
2095,2,44,46,1.1566175875270359e-05,0.000204129919415075,0.0001192445082719397
2096,29,19,48,0.00016770955019142022,8.814701065650966e-05,0.0001244290521098501
2097,23,10,33,0.00013301102256560912,4.639316350342614e-05,8.554497332552195e-05
2098,15,28,43,8.67463190645277e-05,0.00012990085780959317,0.00011146769251507406
2099,21,27,48,0.00012144484669033877,0.00012526154145925056,0.0001244290521098501
2100,7,38,45,4.048161556344626e-05,0.00017629402131301932,0.00011665223635298449
2101,10,44,54,5.78308793763518e-05,0.000204129919415075,0.00013998268362358138
2102,4,31,35,2.3132351750540717e-05,0.00014381880686062103,9.072951716343238e-05
2103,26,22,48,0.00015036028637851467,0.0001020649597075375,0.0001244290521098501
2104,5,28,33,2.89154396881759e-05,0.00012990085780959317,8.554497332552195e-05
2105,30,19,49,0.0001734926381290554,8.814701065650966e-05,0.00012702132402880534
2106,13,22,35,7.518014318925733e-05,0.0001020649597075375,9.072951716343238e-05
2107,3,49,52,1.7349263812905538e-05,0.00022732650116678805,0.00013479813978567096
2108,23,27,50,0.00013301102256560912,0.00012526154145925056,0.00012961359594776053
2109,26,23,49,0.00015036028637851467,0.00010670427605788011,0.00012702132402880534
2110,50,11,61,0.000289154396881759,5.103247985376875e-05,0.00015812858705626786
2111,12,28,40,6.939705525162215e-05,0.00012990085780959317,0.00010369087675820843
2112,9,35,44,5.204779143871662e-05,0.00016237607226199147,0.00011405996443402927
2113,7,43,50,4.048161556344626e-05,0.00019949060306473238,0.00012961359594776053
2114,61,1,62,0.000352768364195746,4.639316350342614e-06,0.00016072085897522306
2115,1,44,45,5.783087937635179e-06,0.000204129919415075,0.00011665223635298449
2116,29,13,42,0.00016770955019142022,6.0311112554453976e-05,0.00010887542059611885
2117,25,25,50,0.0001445771984408795,0.00011598290875856534,0.00012961359594776053
2118,2,42,44,1.1566175875270359e-05,0.00019485128671438976,0.00011405996443402927
2119,11,35,46,6.361396731398698e-05,0.00016237607226199147,0.0001192445082719397
2120,19,28,47,0.00010987867081506842,0.00012990085780959317,0.0001218367801908949
2121,8,51,59,4.6264703501081435e-05,0.0002366051338674733,0.00015294404321835743
2122,1,52,53,5.783087937635179e-06,0.0002412444502178159,0.00013739041170462616
2123,30,18,48,0.0001734926381290554,8.350769430616704e-05,0.0001244290521098501
2124,18,27,45,0.00010409558287743323,0.00012526154145925056,0.00011665223635298449
2125,28,20,48,0.00016192646225378504,9.278632700685228e-05,0.0001244290521098501
2126,2,41,43,1.1566175875270359e-05,0.00019021197036404714,0.00011146769251507406
2127,38,14,52,0.00021975734163013684,6.495042890479659e-05,0.00013479813978567096
2128,32,21,53,0.00018505881400432574,9.742564335719488e-05,0.00013739041170462616
2129,34,9,43,0.0001966249898795961,4.175384715308352e-05,0.00011146769251507406
2130,19,33,52,0.00010987867081506842,0.00015309743956130623,0.00013479813978567096
2131,13,31,44,7.518014318925733e-05,0.00014381880686062103,0.00011405996443402927
2132,9,34,43,5.204779143871662e-05,0.00015773675591164885,0.00011146769251507406
2133,36,14,50,0.00020819116575486647,6.495042890479659e-05,0.00012961359594776053
2134,1,43,44,5.783087937635179e-06,0.00019949060306473238,0.00011405996443402927
2135,9,40,49,5.204779143871662e-05,0.00018557265401370455,0.00012702132402880534
2136,18,27,45,0.00010409558287743323,0.00012526154145925056,0.00011665223635298449
2137,3,39,42,1.7349263812905538e-05,0.00018093333766336194,0.00010887542059611885
2138,18,29,47,0.00010409558287743323,0.0001345401741599358,0.0001218367801908949
2139,30,5,35,0.0001734926381290554,2.319658175171307e-05,9.072951716343238e-05
2140,8,41,49,4.6264703501081435e-05,0.00019021197036404714,0.00012702132402880534
2141,1,46,47,5.783087937635179e-06,0.00021340855211576023,0.0001218367801908949
2142,21,20,41,0.00012144484669033877,9.278632700685228e-05,0.00010628314867716364
2143,8,44,52,4.6264703501081435e-05,0.000204129919415075,0.00013479813978567096
2144,14,24,38,8.096323112689252e-05,0.00011134359240822272,9.850633292029801e-05
2145,20,21,41,0.0001156617587527036,9.742564335719488e-05,0.00010628314867716364
2146,37,3,40,0.00021397425369250165,1.391794905102784e-05,0.00010369087675820843
2147,26,14,40,0.00015036028637851467,6.495042890479659e-05,0.00010369087675820843
2148,20,20,40,0.0001156617587527036,9.278632700685228e-05,0.00010369087675820843
2149,26,16,42,0.00015036028637851467,7.422906160548182e-05,0.00010887542059611885
2150,34,18,52,0.0001966249898795961,8.350769430616704e-05,0.00013479813978567096
2151,33,14,47,0.00019084190194196092,6.495042890479659e-05,0.0001218367801908949
2152,24,21,45,0.0001387941105032443,9.742564335719488e-05,0.00011665223635298449
2153,23,33,56,0.00013301102256560912,0.00015309743956130623,0.0001451672274614918
2154,17,34,51,9.831249493979805e-05,0.00015773675591164885,0.00013220586786671573
2155,3,45,48,1.7349263812905538e-05,0.0002087692357654176,0.0001244290521098501
2156,19,22,41,0.00010987867081506842,0.0001020649597075375,0.00010628314867716364
2157,9,33,42,5.204779143871662e-05,0.00015309743956130623,0.00010887542059611885
2158,1,41,42,5.783087937635179e-06,0.00019021197036404714,0.00010887542059611885
2159,27,19,46,0.00015614337431614985,8.814701065650966e-05,0.0001192445082719397
2160,43,5,48,0.00024867278131831275,2.319658175171307e-05,0.0001244290521098501
2161,33,10,43,0.00019084190194196092,4.639316350342614e-05,0.00011146769251507406
2162,43,15,58,0.00024867278131831275,6.95897452551392e-05,0.00015035177129940223
2163,1,42,43,5.783087937635179e-06,0.00019485128671438976,0.00011146769251507406
2164,35,11,46,0.0002024080778172313,5.103247985376875e-05,0.0001192445082719397
2165,25,17,42,0.0001445771984408795,7.886837795582442e-05,0.00010887542059611885
2166,11,35,46,6.361396731398698e-05,0.00016237607226199147,0.0001192445082719397
2167,14,27,41,8.096323112689252e-05,0.00012526154145925056,0.00010628314867716364
2168,36,11,47,0.00020819116575486647,5.103247985376875e-05,0.0001218367801908949
2169,25,27,52,0.0001445771984408795,0.00012526154145925056,0.00013479813978567096
2170,48,3,51,0.0002775882210064886,1.391794905102784e-05,0.00013220586786671573
2171,23,12,35,0.00013301102256560912,5.567179620411136e-05,9.072951716343238e-05
2172,6,40,46,3.4698527625811076e-05,0.00018557265401370455,0.0001192445082719397
2173,39,7,46,0.00022554042956777202,3.247521445239829e-05,0.0001192445082719397
2174,22,20,42,0.00012722793462797397,9.278632700685228e-05,0.00010887542059611885
2175,13,32,45,7.518014318925733e-05,0.00014845812321096364,0.00011665223635298449
2176,7,38,45,4.048161556344626e-05,0.00017629402131301932,0.00011665223635298449
2177,49,2,51,0.0002833713089441238,9.278632700685228e-06,0.00013220586786671573
2178,18,18,36,0.00010409558287743323,8.350769430616704e-05,9.332178908238759e-05
2179,14,32,46,8.096323112689252e-05,0.00014845812321096364,0.0001192445082719397
2180,15,27,42,8.67463190645277e-05,0.00012526154145925056,0.00010887542059611885
2181,1,40,41,5.783087937635179e-06,0.00018557265401370455,0.00010628314867716364
2182,16,31,47,9.252940700216287e-05,0.00014381880686062103,0.0001218367801908949
2183,4,48,52,2.3132351750540717e-05,0.00022268718481644544,0.00013479813978567096
2184,16,19,35,9.252940700216287e-05,8.814701065650966e-05,9.072951716343238e-05
2185,6,26,32,3.4698527625811076e-05,0.00012062222510890795,8.295270140656674e-05
2186,18,40,58,0.00010409558287743323,0.00018557265401370455,0.00015035177129940223
2187,14,35,49,8.096323112689252e-05,0.00016237607226199147,0.00012702132402880534
2188,20,35,55,0.0001156617587527036,0.00016237607226199147,0.00014257495554253658
2189,1,32,33,5.783087937635179e-06,0.00014845812321096364,8.554497332552195e-05
2190,18,23,41,0.00010409558287743323,0.00010670427605788011,0.00010628314867716364
2191,17,27,44,9.831249493979805e-05,0.00012526154145925056,0.00011405996443402927
2192,29,14,43,0.00016770955019142022,6.495042890479659e-05,0.00011146769251507406
2193,10,31,41,5.78308793763518e-05,0.00014381880686062103,0.00010628314867716364
2194,42,10,52,0.00024288969338067754,4.639316350342614e-05,0.00013479813978567096
2195,13,36,49,7.518014318925733e-05,0.00016701538861233408,0.00012702132402880534
2196,24,34,58,0.0001387941105032443,0.00015773675591164885,0.00015035177129940223
2197,18,24,42,0.00010409558287743323,0.00011134359240822272,0.00010887542059611885
2198,21,24,45,0.00012144484669033877,0.00011134359240822272,0.00011665223635298449
2199,26,16,42,0.00015036028637851467,7.422906160548182e-05,0.00010887542059611885
2200,8,36,44,4.6264703501081435e-05,0.00016701538861233408,0.00011405996443402927
2201,25,33,58,0.0001445771984408795,0.00015309743956130623,0.00015035177129940223
2202,26,17,43,0.00015036028637851467,7.886837795582442e-05,0.00011146769251507406
2203,23,36,59,0.00013301102256560912,0.00016701538861233408,0.00015294404321835743
2204,14,34,48,8.096323112689252e-05,0.00015773675591164885,0.0001244290521098501
2205,24,18,42,0.0001387941105032443,8.350769430616704e-05,0.00010887542059611885
2206,2,54,56,1.1566175875270359e-05,0.0002505230829185011,0.0001451672274614918
2207,17,26,43,9.831249493979805e-05,0.00012062222510890795,0.00011146769251507406
2208,31,17,48,0.00017927572606669058,7.886837795582442e-05,0.0001244290521098501
2209,20,20,40,0.0001156617587527036,9.278632700685228e-05,0.00010369087675820843
2210,36,13,49,0.00020819116575486647,6.0311112554453976e-05,0.00012702132402880534
2211,16,28,44,9.252940700216287e-05,0.00012990085780959317,0.00011405996443402927
2212,13,24,37,7.518014318925733e-05,0.00011134359240822272,9.59140610013428e-05
2213,21,23,44,0.00012144484669033877,0.00010670427605788011,0.00011405996443402927
2214,12,33,45,6.939705525162215e-05,0.00015309743956130623,0.00011665223635298449
2215,21,11,32,0.00012144484669033877,5.103247985376875e-05,8.295270140656674e-05
2216,12,33,45,6.939705525162215e-05,0.00015309743956130623,0.00011665223635298449
2217,33,14,47,0.00019084190194196092,6.495042890479659e-05,0.0001218367801908949
2218,3,38,41,1.7349263812905538e-05,0.00017629402131301932,0.00010628314867716364
2219,19,18,37,0.00010987867081506842,8.350769430616704e-05,9.59140610013428e-05
2220,23,20,43,0.00013301102256560912,9.278632700685228e-05,0.00011146769251507406
2221,4,49,53,2.3132351750540717e-05,0.00022732650116678805,0.00013739041170462616
2222,13,22,35,7.518014318925733e-05,0.0001020649597075375,9.072951716343238e-05
2223,27,18,45,0.00015614337431614985,8.350769430616704e-05,0.00011665223635298449
2224,19,29,48,0.00010987867081506842,0.0001345401741599358,0.0001244290521098501
2225,1,45,46,5.783087937635179e-06,0.0002087692357654176,0.0001192445082719397
2226,9,37,46,5.204779143871662e-05,0.0001716547049626767,0.0001192445082719397
2227,34,3,37,0.0001966249898795961,1.391794905102784e-05,9.59140610013428e-05
2228,4,33,37,2.3132351750540717e-05,0.00015309743956130623,9.59140610013428e-05
2229,5,31,36,2.89154396881759e-05,0.00014381880686062103,9.332178908238759e-05
2230,21,20,41,0.00012144484669033877,9.278632700685228e-05,0.00010628314867716364
2231,14,30,44,8.096323112689252e-05,0.0001391794905102784,0.00011405996443402927
2232,1,41,42,5.783087937635179e-06,0.00019021197036404714,0.00010887542059611885
2233,24,32,56,0.0001387941105032443,0.00014845812321096364,0.0001451672274614918
2234,11,28,39,6.361396731398698e-05,0.00012990085780959317,0.00010109860483925321
2235,3,36,39,1.7349263812905538e-05,0.00016701538861233408,0.00010109860483925321
2236,42,16,58,0.00024288969338067754,7.422906160548182e-05,0.00015035177129940223
2237,1,37,38,5.783087937635179e-06,0.0001716547049626767,9.850633292029801e-05
2238,12,33,45,6.939705525162215e-05,0.00015309743956130623,0.00011665223635298449
2239,31,24,55,0.00017927572606669058,0.00011134359240822272,0.00014257495554253658
2240,16,28,44,9.252940700216287e-05,0.00012990085780959317,0.00011405996443402927
2241,19,26,45,0.00010987867081506842,0.00012062222510890795,0.00011665223635298449
2242,14,27,41,8.096323112689252e-05,0.00012526154145925056,0.00010628314867716364
2243,21,30,51,0.00012144484669033877,0.0001391794905102784,0.00013220586786671573
2244,12,26,38,6.939705525162215e-05,0.00012062222510890795,9.850633292029801e-05
2245,17,23,40,9.831249493979805e-05,0.00010670427605788011,0.00010369087675820843
2246,2,43,45,1.1566175875270359e-05,0.00019949060306473238,0.00011665223635298449
2247,12,32,44,6.939705525162215e-05,0.00014845812321096364,0.00011405996443402927
2248,9,28,37,5.204779143871662e-05,0.00012990085780959317,9.59140610013428e-05
2249,21,22,43,0.00012144484669033877,0.0001020649597075375,0.00011146769251507406
2250,4,20,24,2.3132351750540717e-05,9.278632700685228e-05,6.221452605492506e-05
2251,27,18,45,0.00015614337431614985,8.350769430616704e-05,0.00011665223635298449
2252,2,42,44,1.1566175875270359e-05,0.00019485128671438976,0.00011405996443402927
2253,5,28,33,2.89154396881759e-05,0.00012990085780959317,8.554497332552195e-05
2254,22,17,39,0.00012722793462797397,7.886837795582442e-05,0.00010109860483925321
2255,26,17,43,0.00015036028637851467,7.886837795582442e-05,0.00011146769251507406
2256,12,26,38,6.939705525162215e-05,0.00012062222510890795,9.850633292029801e-05
2257,8,34,42,4.6264703501081435e-05,0.00015773675591164885,0.00010887542059611885
2258,12,29,41,6.939705525162215e-05,0.0001345401741599358,0.00010628314867716364
2259,1,50,51,5.783087937635179e-06,0.00023196581751713067,0.00013220586786671573
2260,32,9,41,0.00018505881400432574,4.175384715308352e-05,0.00010628314867716364
2261,21,19,40,0.00012144484669033877,8.814701065650966e-05,0.00010369087675820843
2262,1,51,52,5.783087937635179e-06,0.0002366051338674733,0.00013479813978567096
2263,40,2,42,0.0002313235175054072,9.278632700685228e-06,0.00010887542059611885
2264,15,23,38,8.67463190645277e-05,0.00010670427605788011,9.850633292029801e-05
2265,26,18,44,0.00015036028637851467,8.350769430616704e-05,0.00011405996443402927
2266,33,9,42,0.00019084190194196092,4.175384715308352e-05,0.00010887542059611885
2267,22,23,45,0.00012722793462797397,0.00010670427605788011,0.00011665223635298449
2268,9,34,43,5.204779143871662e-05,0.00015773675591164885,0.00011146769251507406
2269,22,22,44,0.00012722793462797397,0.0001020649597075375,0.00011405996443402927
2270,1,33,34,5.783087937635179e-06,0.00015309743956130623,8.813724524447716e-05
2271,1,41,42,5.783087937635179e-06,0.00019021197036404714,0.00010887542059611885
2272,26,14,40,0.00015036028637851467,6.495042890479659e-05,0.00010369087675820843
2273,7,16,23,4.048161556344626e-05,7.422906160548182e-05,5.962225413596985e-05
2274,13,30,43,7.518014318925733e-05,0.0001391794905102784,0.00011146769251507406
2275,20,18,38,0.0001156617587527036,8.350769430616704e-05,9.850633292029801e-05
2276,5,42,47,2.89154396881759e-05,0.00019485128671438976,0.0001218367801908949
2277,19,23,42,0.00010987867081506842,0.00010670427605788011,0.00010887542059611885
2278,26,21,47,0.00015036028637851467,9.742564335719488e-05,0.0001218367801908949
2279,16,25,41,9.252940700216287e-05,0.00011598290875856534,0.00010628314867716364
2280,27,18,45,0.00015614337431614985,8.350769430616704e-05,0.00011665223635298449
2281,11,37,48,6.361396731398698e-05,0.0001716547049626767,0.0001244290521098501
2282,26,21,47,0.00015036028637851467,9.742564335719488e-05,0.0001218367801908949
2283,3,38,41,1.7349263812905538e-05,0.00017629402131301932,0.00010628314867716364
2284,9,32,41,5.204779143871662e-05,0.00014845812321096364,0.00010628314867716364
2285,16,27,43,9.252940700216287e-05,0.00012526154145925056,0.00011146769251507406
2286,1,43,44,5.783087937635179e-06,0.00019949060306473238,0.00011405996443402927
2287,31,13,44,0.00017927572606669058,6.0311112554453976e-05,0.00011405996443402927
2288,14,35,49,8.096323112689252e-05,0.00016237607226199147,0.00012702132402880534
2289,8,38,46,4.6264703501081435e-05,0.00017629402131301932,0.0001192445082719397
2290,6,43,49,3.4698527625811076e-05,0.00019949060306473238,0.00012702132402880534
2291,1,28,29,5.783087937635179e-06,0.00012990085780959317,7.517588564970112e-05
2292,4,37,41,2.3132351750540717e-05,0.0001716547049626767,0.00010628314867716364
2293,27,10,37,0.00015614337431614985,4.639316350342614e-05,9.59140610013428e-05
2294,14,30,44,8.096323112689252e-05,0.0001391794905102784,0.00011405996443402927
2295,14,28,42,8.096323112689252e-05,0.00012990085780959317,0.00010887542059611885
2296,19,23,42,0.00010987867081506842,0.00010670427605788011,0.00010887542059611885
2297,2,39,41,1.1566175875270359e-05,0.00018093333766336194,0.00010628314867716364
2298,5,35,40,2.89154396881759e-05,0.00016237607226199147,0.00010369087675820843
2299,25,18,43,0.0001445771984408795,8.350769430616704e-05,0.00011146769251507406
2300,24,9,33,0.0001387941105032443,4.175384715308352e-05,8.554497332552195e-05
2301,18,25,43,0.00010409558287743323,0.00011598290875856534,0.00011146769251507406
2302,27,9,36,0.00015614337431614985,4.175384715308352e-05,9.332178908238759e-05
2303,14,39,53,8.096323112689252e-05,0.00018093333766336194,0.00013739041170462616
2304,9,35,44,5.204779143871662e-05,0.00016237607226199147,0.00011405996443402927
2305,2,30,32,1.1566175875270359e-05,0.0001391794905102784,8.295270140656674e-05
2306,6,44,50,3.4698527625811076e-05,0.000204129919415075,0.00012961359594776053
2307,7,33,40,4.048161556344626e-05,0.00015309743956130623,0.00010369087675820843
2308,8,36,44,4.6264703501081435e-05,0.00016701538861233408,0.00011405996443402927
2309,2,44,46,1.1566175875270359e-05,0.000204129919415075,0.0001192445082719397
2310,19,38,57,0.00010987867081506842,0.00017629402131301932,0.000147759499380447
2311,7,36,43,4.048161556344626e-05,0.00016701538861233408,0.00011146769251507406
2312,12,25,37,6.939705525162215e-05,0.00011598290875856534,9.59140610013428e-05
2313,21,22,43,0.00012144484669033877,0.0001020649597075375,0.00011146769251507406
2314,1,47,48,5.783087937635179e-06,0.00021804786846610285,0.0001244290521098501
2315,38,3,41,0.00021975734163013684,1.391794905102784e-05,0.00010628314867716364
2316,15,22,37,8.67463190645277e-05,0.0001020649597075375,9.59140610013428e-05
2317,31,11,42,0.00017927572606669058,5.103247985376875e-05,0.00010887542059611885
2318,26,17,43,0.00015036028637851467,7.886837795582442e-05,0.00011146769251507406
2319,43,5,48,0.00024867278131831275,2.319658175171307e-05,0.0001244290521098501
2320,28,8,36,0.00016192646225378504,3.711453080274091e-05,9.332178908238759e-05
2321,1,38,39,5.783087937635179e-06,0.00017629402131301932,0.00010109860483925321
2322,1,32,33,5.783087937635179e-06,0.00014845812321096364,8.554497332552195e-05
2323,37,5,42,0.00021397425369250165,2.319658175171307e-05,0.00010887542059611885
2324,22,17,39,0.00012722793462797397,7.886837795582442e-05,0.00010109860483925321
2325,30,18,48,0.0001734926381290554,8.350769430616704e-05,0.0001244290521098501
2326,32,11,43,0.00018505881400432574,5.103247985376875e-05,0.00011146769251507406
2327,31,13,44,0.00017927572606669058,6.0311112554453976e-05,0.00011405996443402927
2328,20,31,51,0.0001156617587527036,0.00014381880686062103,0.00013220586786671573
2329,7,30,37,4.048161556344626e-05,0.0001391794905102784,9.59140610013428e-05
2330,25,19,44,0.0001445771984408795,8.814701065650966e-05,0.00011405996443402927
2331,26,4,30,0.00015036028637851467,1.8557265401370455e-05,7.776815756865632e-05
2332,25,18,43,0.0001445771984408795,8.350769430616704e-05,0.00011146769251507406
2333,7,28,35,4.048161556344626e-05,0.00012990085780959317,9.072951716343238e-05
2334,31,6,37,0.00017927572606669058,2.783589810205568e-05,9.59140610013428e-05
2335,1,39,40,5.783087937635179e-06,0.00018093333766336194,0.00010369087675820843
2336,3,36,39,1.7349263812905538e-05,0.00016701538861233408,0.00010109860483925321
2337,5,35,40,2.89154396881759e-05,0.00016237607226199147,0.00010369087675820843
2338,17,26,43,9.831249493979805e-05,0.00012062222510890795,0.00011146769251507406
2339,36,5,41,0.00020819116575486647,2.319658175171307e-05,0.00010628314867716364
2340,22,19,41,0.00012722793462797397,8.814701065650966e-05,0.00010628314867716364
2341,2,41,43,1.1566175875270359e-05,0.00019021197036404714,0.00011146769251507406
2342,2,34,36,1.1566175875270359e-05,0.00015773675591164885,9.332178908238759e-05
2343,4,32,36,2.3132351750540717e-05,0.00014845812321096364,9.332178908238759e-05
2344,1,38,39,5.783087937635179e-06,0.00017629402131301932,0.00010109860483925321
2345,29,1,30,0.00016770955019142022,4.639316350342614e-06,7.776815756865632e-05
2346,36,3,39,0.00020819116575486647,1.391794905102784e-05,0.00010109860483925321
2347,17,26,43,9.831249493979805e-05,0.00012062222510890795,0.00011146769251507406
2348,22,20,42,0.00012722793462797397,9.278632700685228e-05,0.00010887542059611885
2349,1,35,36,5.783087937635179e-06,0.00016237607226199147,9.332178908238759e-05
2350,1,45,46,5.783087937635179e-06,0.0002087692357654176,0.0001192445082719397
2351,12,23,35,6.939705525162215e-05,0.00010670427605788011,9.072951716343238e-05
2352,1,47,48,5.783087937635179e-06,0.00021804786846610285,0.0001244290521098501
2353,21,19,40,0.00012144484669033877,8.814701065650966e-05,0.00010369087675820843
2354,5,16,21,2.89154396881759e-05,7.422906160548182e-05,5.4437710298059425e-05
2355,25,1,26,0.0001445771984408795,4.639316350342614e-06,6.739906989283548e-05
2356,4,48,52,2.3132351750540717e-05,0.00022268718481644544,0.00013479813978567096
2357,16,17,33,9.252940700216287e-05,7.886837795582442e-05,8.554497332552195e-05
2358,4,35,39,2.3132351750540717e-05,0.00016237607226199147,0.00010109860483925321
2359,12,38,50,6.939705525162215e-05,0.00017629402131301932,0.00012961359594776053
2360,16,29,45,9.252940700216287e-05,0.0001345401741599358,0.00011665223635298449
2361,1,40,41,5.783087937635179e-06,0.00018557265401370455,0.00010628314867716364
2362,23,15,38,0.00013301102256560912,6.95897452551392e-05,9.850633292029801e-05
2363,1,55,56,5.783087937635179e-06,0.00025516239926884376,0.0001451672274614918
2364,18,25,43,0.00010409558287743323,0.00011598290875856534,0.00011146769251507406
2365,1,57,58,5.783087937635179e-06,0.000264441031969529,0.00015035177129940223
2366,10,19,29,5.78308793763518e-05,8.814701065650966e-05,7.517588564970112e-05
2367,28,13,41,0.00016192646225378504,6.0311112554453976e-05,0.00010628314867716364
2368,13,31,44,7.518014318925733e-05,0.00014381880686062103,0.00011405996443402927
2369,6,15,21,3.4698527625811076e-05,6.95897452551392e-05,5.4437710298059425e-05
2370,20,22,42,0.0001156617587527036,0.0001020649597075375,0.00010887542059611885
2371,12,30,42,6.939705525162215e-05,0.0001391794905102784,0.00010887542059611885
2372,27,17,44,0.00015614337431614985,7.886837795582442e-05,0.00011405996443402927
2373,17,22,39,9.831249493979805e-05,0.0001020649597075375,0.00010109860483925321
2374,1,39,40,5.783087937635179e-06,0.00018093333766336194,0.00010369087675820843
2375,32,11,43,0.00018505881400432574,5.103247985376875e-05,0.00011146769251507406
2376,15,20,35,8.67463190645277e-05,9.278632700685228e-05,9.072951716343238e-05
2377,32,5,37,0.00018505881400432574,2.319658175171307e-05,9.59140610013428e-05
2378,6,33,39,3.4698527625811076e-05,0.00015309743956130623,0.00010109860483925321
2379,23,19,42,0.00013301102256560912,8.814701065650966e-05,0.00010887542059611885
2380,14,33,47,8.096323112689252e-05,0.00015309743956130623,0.0001218367801908949
2381,1,40,41,5.783087937635179e-06,0.00018557265401370455,0.00010628314867716364
2382,25,14,39,0.0001445771984408795,6.495042890479659e-05,0.00010109860483925321
2383,29,9,38,0.00016770955019142022,4.175384715308352e-05,9.850633292029801e-05
2384,9,26,35,5.204779143871662e-05,0.00012062222510890795,9.072951716343238e-05
2385,3,30,33,1.7349263812905538e-05,0.0001391794905102784,8.554497332552195e-05
2386,29,11,40,0.00016770955019142022,5.103247985376875e-05,0.00010369087675820843
2387,10,40,50,5.78308793763518e-05,0.00018557265401370455,0.00012961359594776053
2388,8,29,37,4.6264703501081435e-05,0.0001345401741599358,9.59140610013428e-05
2389,8,19,27,4.6264703501081435e-05,8.814701065650966e-05,6.999134181179069e-05
2390,30,15,45,0.0001734926381290554,6.95897452551392e-05,0.00011665223635298449
2391,11,5,16,6.361396731398698e-05,2.319658175171307e-05,4.147635070328337e-05
2392,46,1,47,0.00026602204513121824,4.639316350342614e-06,0.0001218367801908949
2393,30,11,41,0.0001734926381290554,5.103247985376875e-05,0.00010628314867716364
2394,18,25,43,0.00010409558287743323,0.00011598290875856534,0.00011146769251507406
2395,24,10,34,0.0001387941105032443,4.639316350342614e-05,8.813724524447716e-05
2396,22,15,37,0.00012722793462797397,6.95897452551392e-05,9.59140610013428e-05
2397,12,30,42,6.939705525162215e-05,0.0001391794905102784,0.00010887542059611885
2398,26,25,51,0.00015036028637851467,0.00011598290875856534,0.00013220586786671573
2399,11,25,36,6.361396731398698e-05,0.00011598290875856534,9.332178908238759e-05
2400,21,19,40,0.00012144484669033877,8.814701065650966e-05,0.00010369087675820843
2401,6,34,40,3.4698527625811076e-05,0.00015773675591164885,0.00010369087675820843
2402,7,40,47,4.048161556344626e-05,0.00018557265401370455,0.0001218367801908949
2403,28,11,39,0.00016192646225378504,5.103247985376875e-05,0.00010109860483925321
2404,1,40,41,5.783087937635179e-06,0.00018557265401370455,0.00010628314867716364
2405,11,31,42,6.361396731398698e-05,0.00014381880686062103,0.00010887542059611885
2406,17,23,40,9.831249493979805e-05,0.00010670427605788011,0.00010369087675820843
2407,27,3,30,0.00015614337431614985,1.391794905102784e-05,7.776815756865632e-05
2408,42,5,47,0.00024288969338067754,2.319658175171307e-05,0.0001218367801908949
2409,6,26,32,3.4698527625811076e-05,0.00012062222510890795,8.295270140656674e-05
2410,3,41,44,1.7349263812905538e-05,0.00019021197036404714,0.00011405996443402927
2411,25,20,45,0.0001445771984408795,9.278632700685228e-05,0.00011665223635298449
2412,8,26,34,4.6264703501081435e-05,0.00012062222510890795,8.813724524447716e-05
2413,36,9,45,0.00020819116575486647,4.175384715308352e-05,0.00011665223635298449
2414,25,15,40,0.0001445771984408795,6.95897452551392e-05,0.00010369087675820843
2415,35,9,44,0.0002024080778172313,4.175384715308352e-05,0.00011405996443402927
2416,18,23,41,0.00010409558287743323,0.00010670427605788011,0.00010628314867716364
2417,29,13,42,0.00016770955019142022,6.0311112554453976e-05,0.00010887542059611885
2418,18,34,52,0.00010409558287743323,0.00015773675591164885,0.00013479813978567096
2419,10,30,40,5.78308793763518e-05,0.0001391794905102784,0.00010369087675820843
2420,14,26,40,8.096323112689252e-05,0.00012062222510890795,0.00010369087675820843
2421,39,4,43,0.00022554042956777202,1.8557265401370455e-05,0.00011146769251507406
2422,19,24,43,0.00010987867081506842,0.00011134359240822272,0.00011146769251507406
2423,43,3,46,0.00024867278131831275,1.391794905102784e-05,0.0001192445082719397
2424,6,32,38,3.4698527625811076e-05,0.00014845812321096364,9.850633292029801e-05
2425,18,28,46,0.00010409558287743323,0.00012990085780959317,0.0001192445082719397
2426,18,24,42,0.00010409558287743323,0.00011134359240822272,0.00010887542059611885
2427,22,11,33,0.00012722793462797397,5.103247985376875e-05,8.554497332552195e-05
2428,6,27,33,3.4698527625811076e-05,0.00012526154145925056,8.554497332552195e-05
2429,4,34,38,2.3132351750540717e-05,0.00015773675591164885,9.850633292029801e-05
2430,9,29,38,5.204779143871662e-05,0.0001345401741599358,9.850633292029801e-05
2431,1,34,35,5.783087937635179e-06,0.00015773675591164885,9.072951716343238e-05
2432,18,24,42,0.00010409558287743323,0.00011134359240822272,0.00010887542059611885
2433,1,46,47,5.783087937635179e-06,0.00021340855211576023,0.0001218367801908949
2434,19,19,38,0.00010987867081506842,8.814701065650966e-05,9.850633292029801e-05
2435,1,41,42,5.783087937635179e-06,0.00019021197036404714,0.00010887542059611885
2436,26,17,43,0.00015036028637851467,7.886837795582442e-05,0.00011146769251507406
2437,41,7,48,0.00023710660544304236,3.247521445239829e-05,0.0001244290521098501
2438,13,29,42,7.518014318925733e-05,0.0001345401741599358,0.00010887542059611885
2439,7,22,29,4.048161556344626e-05,0.0001020649597075375,7.517588564970112e-05
2440,29,20,49,0.00016770955019142022,9.278632700685228e-05,0.00012702132402880534
2441,9,28,37,5.204779143871662e-05,0.00012990085780959317,9.59140610013428e-05
2442,28,12,40,0.00016192646225378504,5.567179620411136e-05,0.00010369087675820843
2443,9,24,33,5.204779143871662e-05,0.00011134359240822272,8.554497332552195e-05
2444,12,27,39,6.939705525162215e-05,0.00012526154145925056,0.00010109860483925321
2445,34,9,43,0.0001966249898795961,4.175384715308352e-05,0.00011146769251507406
2446,2,39,41,1.1566175875270359e-05,0.00018093333766336194,0.00010628314867716364
2447,2,36,38,1.1566175875270359e-05,0.00016701538861233408,9.850633292029801e-05
2448,5,41,46,2.89154396881759e-05,0.00019021197036404714,0.0001192445082719397
2449,16,23,39,9.252940700216287e-05,0.00010670427605788011,0.00010109860483925321
2450,17,17,34,9.831249493979805e-05,7.886837795582442e-05,8.813724524447716e-05
2451,6,35,41,3.4698527625811076e-05,0.00016237607226199147,0.00010628314867716364
2452,13,28,41,7.518014318925733e-05,0.00012990085780959317,0.00010628314867716364
2453,1,38,39,5.783087937635179e-06,0.00017629402131301932,0.00010109860483925321
2454,13,27,40,7.518014318925733e-05,0.00012526154145925056,0.00010369087675820843
2455,21,15,36,0.00012144484669033877,6.95897452551392e-05,9.332178908238759e-05
2456,15,17,32,8.67463190645277e-05,7.886837795582442e-05,8.295270140656674e-05
2457,15,20,35,8.67463190645277e-05,9.278632700685228e-05,9.072951716343238e-05
2458,23,13,36,0.00013301102256560912,6.0311112554453976e-05,9.332178908238759e-05
2459,1,35,36,5.783087937635179e-06,0.00016237607226199147,9.332178908238759e-05
2460,32,7,39,0.00018505881400432574,3.247521445239829e-05,0.00010109860483925321
2461,30,8,38,0.0001734926381290554,3.711453080274091e-05,9.850633292029801e-05
2462,22,17,39,0.00012722793462797397,7.886837795582442e-05,0.00010109860483925321
2463,6,35,41,3.4698527625811076e-05,0.00016237607226199147,0.00010628314867716364
2464,10,28,38,5.78308793763518e-05,0.00012990085780959317,9.850633292029801e-05
2465,5,28,33,2.89154396881759e-05,0.00012990085780959317,8.554497332552195e-05
2466,1,32,33,5.783087937635179e-06,0.00014845812321096364,8.554497332552195e-05
2467,13,25,38,7.518014318925733e-05,0.00011598290875856534,9.850633292029801e-05
2468,34,3,37,0.0001966249898795961,1.391794905102784e-05,9.59140610013428e-05
2469,7,26,33,4.048161556344626e-05,0.00012062222510890795,8.554497332552195e-05
2470,31,12,43,0.00017927572606669058,5.567179620411136e-05,0.00011146769251507406
2471,1,23,24,5.783087937635179e-06,0.00010670427605788011,6.221452605492506e-05
2472,29,13,42,0.00016770955019142022,6.0311112554453976e-05,0.00010887542059611885
2473,22,19,41,0.00012722793462797397,8.814701065650966e-05,0.00010628314867716364
2474,2,30,32,1.1566175875270359e-05,0.0001391794905102784,8.295270140656674e-05
2475,17,14,31,9.831249493979805e-05,6.495042890479659e-05,8.036042948761153e-05
2476,9,19,28,5.204779143871662e-05,8.814701065650966e-05,7.25836137307459e-05
2477,20,17,37,0.0001156617587527036,7.886837795582442e-05,9.59140610013428e-05
2478,3,22,25,1.7349263812905538e-05,0.0001020649597075375,6.480679797388027e-05
2479,4,25,29,2.3132351750540717e-05,0.00011598290875856534,7.517588564970112e-05
2480,27,13,40,0.00015614337431614985,6.0311112554453976e-05,0.00010369087675820843
2481,7,37,44,4.048161556344626e-05,0.0001716547049626767,0.00011405996443402927
2482,1,40,41,5.783087937635179e-06,0.00018557265401370455,0.00010628314867716364
2483,20,18,38,0.0001156617587527036,8.350769430616704e-05,9.850633292029801e-05
2484,10,22,32,5.78308793763518e-05,0.0001020649597075375,8.295270140656674e-05
2485,9,38,47,5.204779143871662e-05,0.00017629402131301932,0.0001218367801908949
2486,13,25,38,7.518014318925733e-05,0.00011598290875856534,9.850633292029801e-05
2487,30,7,37,0.0001734926381290554,3.247521445239829e-05,9.59140610013428e-05
2488,11,23,34,6.361396731398698e-05,0.00010670427605788011,8.813724524447716e-05
2489,3,31,34,1.7349263812905538e-05,0.00014381880686062103,8.813724524447716e-05
2490,8,31,39,4.6264703501081435e-05,0.00014381880686062103,0.00010109860483925321
2491,38,4,42,0.00021975734163013684,1.8557265401370455e-05,0.00010887542059611885
2492,35,1,36,0.0002024080778172313,4.639316350342614e-06,9.332178908238759e-05
2493,3,37,40,1.7349263812905538e-05,0.0001716547049626767,0.00010369087675820843
2494,13,26,39,7.518014318925733e-05,0.00012062222510890795,0.00010109860483925321
2495,5,29,34,2.89154396881759e-05,0.0001345401741599358,8.813724524447716e-05
2496,36,2,38,0.00020819116575486647,9.278632700685228e-06,9.850633292029801e-05
2497,1,18,19,5.783087937635179e-06,8.350769430616704e-05,4.925316646014901e-05
2498,1,37,38,5.783087937635179e-06,0.0001716547049626767,9.850633292029801e-05
2499,3,30,33,1.7349263812905538e-05,0.0001391794905102784,8.554497332552195e-05
2500,43,2,45,0.00024867278131831275,9.278632700685228e-06,0.00011665223635298449
